Rk,Squad,# Pl,90s,Tackles: Tkl,Tackles: TklW,Tackles: Def 3rd,Tackles: Mid 3rd,Tackles: Att 3rd,Vs Dribbles: Tkl,Vs Dribbles: Att,Vs Dribbles: Tkl%,Vs Dribbles: Past,Pressures: Press,Pressures: Succ,Pressures: %,Pressures: Def 3rd,Pressures: Mid 3rd,Pressures: Att 3rd,Blocks: Blocks,Blocks: Sh,Blocks: ShSv,Blocks: Pass,Int,Tkl+Int,Clr,Err,League,Season,TeamID
1,Alavés,24,11.0,169,104,81,65,23,48,166,28.9,118,1762,441,25.0,659,768,335,179,45,1,134,138,307,360,3,La Liga,2021-2022,37745278530914180
2,Angers,22,12.0,277,176,149,105,23,114,263,43.3,149,2077,609,29.3,755,919,403,183,29,0,154,176,453,204,3,Ligue 1,2021-2022,66587352409382849
3,Arminia,22,10.0,162,102,67,75,20,47,122,38.5,75,1735,512,29.5,478,816,441,153,39,1,114,146,308,244,6,Bundesliga,2021-2022,60726784699523350
4,Arsenal,26,10.0,141,82,66,53,22,53,121,43.8,68,1276,328,25.7,403,511,362,184,50,0,134,141,282,195,6,Premier League,2021-2022,5838645288327307
5,Aston Villa,23,10.0,140,85,58,62,20,47,141,33.3,94,1298,362,27.9,392,587,319,159,53,1,106,157,297,177,2,Premier League,2021-2022,14348480492050895
6,Atalanta,24,11.0,173,94,78,72,23,63,146,43.2,83,1616,560,34.7,514,703,399,174,38,1,136,152,325,195,2,Serie A,2021-2022,87465877057901989
7,Athletic Club,23,11.0,169,108,70,68,31,63,156,40.4,93,1707,461,27.0,420,790,497,176,35,0,141,129,298,239,1,La Liga,2021-2022,4823083458145023
8,Atlético Madrid,21,11.0,187,114,88,79,20,69,170,40.6,101,1368,421,30.8,428,613,327,129,27,0,102,122,309,170,4,La Liga,2021-2022,74713976168286555
9,Augsburg,24,10.0,166,100,72,71,23,53,155,34.2,102,1530,489,32.0,529,711,290,185,47,1,138,147,313,238,0,Bundesliga,2021-2022,82828683183786310
10,Barcelona,27,11.0,181,121,74,75,32,69,162,42.6,93,1418,486,34.3,397,659,362,152,25,1,127,111,292,169,2,La Liga,2021-2022,81744823723090567
11,Bayern Munich,22,10.0,185,108,76,73,36,74,158,46.8,84,1362,460,33.8,377,597,388,130,12,0,118,162,347,138,2,Bundesliga,2021-2022,7510926916741648
12,Betis,29,12.0,209,140,104,73,32,83,204,40.7,121,1627,473,29.1,539,726,362,182,34,1,148,145,354,300,3,La Liga,2021-2022,9423348454032625
13,Bochum,24,10.0,186,117,89,64,33,69,179,38.5,110,1633,488,29.9,552,714,367,164,41,4,123,204,390,252,3,Bundesliga,2021-2022,26656491983030423
14,Bologna,24,11.0,154,90,83,55,16,60,151,39.7,91,1353,372,27.5,572,510,271,149,44,0,105,106,260,186,7,Serie A,2021-2022,23275147453355121
15,Bordeaux,28,12.0,204,127,98,85,21,77,221,34.8,144,1747,469,26.8,537,856,354,149,33,2,116,195,399,238,3,Ligue 1,2021-2022,12683680850395737
16,Brentford,21,10.0,193,120,88,78,27,69,158,43.7,89,1522,452,29.7,534,654,334,157,25,2,132,153,346,234,3,Premier League,2021-2022,27125852983275500
17,Brest,22,12.0,212,144,112,76,24,67,200,33.5,133,2060,611,29.7,706,950,404,163,30,1,133,209,421,277,2,Ligue 1,2021-2022,27328509848090670
18,Brighton,21,10.0,207,126,107,69,31,63,145,43.4,82,1572,485,30.9,563,607,402,180,40,1,140,135,342,185,1,Premier League,2021-2022,49072214318111932
19,Burnley,18,10.0,161,94,70,66,25,59,137,43.1,78,1221,367,30.1,365,528,328,190,65,5,125,152,313,217,5,Premier League,2021-2022,21823480134907726
20,Cádiz,26,12.0,239,148,132,85,22,88,223,39.5,135,2003,541,27.0,812,887,304,209,42,0,167,165,404,348,4,La Liga,2021-2022,1007679934589500
21,Cagliari,26,11.0,142,93,71,54,17,47,130,36.2,83,1461,378,25.9,580,587,294,160,54,0,106,155,297,220,2,Serie A,2021-2022,32968728316179674
22,Celta Vigo,22,12.0,220,140,106,88,26,59,171,34.5,112,1726,566,32.8,527,792,407,180,30,1,150,163,383,218,1,La Liga,2021-2022,14218303985450920
23,Chelsea,25,10.0,187,110,91,70,26,59,173,34.1,114,1433,435,30.4,474,596,363,166,42,3,124,142,329,254,2,Premier League,2021-2022,58172670324373785
24,Clermont Foot,20,12.0,229,152,105,87,37,100,219,45.7,119,1731,556,32.1,566,794,371,155,32,1,123,157,386,180,4,Ligue 1,2021-2022,54976968050746588
25,Crystal Palace,19,10.0,180,110,100,65,15,66,149,44.3,83,1638,450,27.5,555,723,360,172,40,0,132,133,313,250,2,Premier League,2021-2022,15352059381074619
26,Dortmund,27,10.0,182,126,75,89,18,68,145,46.9,77,1466,531,36.2,432,682,352,155,33,0,122,132,314,189,3,Bundesliga,2021-2022,6921931827204601
27,Eint Frankfurt,24,10.0,194,119,85,81,28,59,174,33.9,115,1632,543,33.3,491,711,430,159,29,1,130,162,356,223,2,Bundesliga,2021-2022,37929111009288632
28,Elche,23,12.0,162,91,89,56,17,55,150,36.7,95,1561,405,25.9,583,712,266,150,40,1,110,186,348,293,5,La Liga,2021-2022,30674441257210497
29,Empoli,24,11.0,189,120,88,69,32,67,169,39.6,102,1703,444,26.1,578,705,420,159,51,1,108,153,342,232,0,Serie A,2021-2022,77726683749984272
30,Espanyol,27,12.0,171,99,84,67,20,65,176,36.9,111,1413,371,26.3,586,581,246,163,45,1,118,133,304,314,7,La Liga,2021-2022,71314269182841176
31,Everton,24,10.0,179,121,102,53,24,74,175,42.3,101,1371,419,30.6,552,548,271,169,42,0,127,163,342,248,2,Premier League,2021-2022,57482013681231466
32,Fiorentina,24,11.0,168,95,73,67,28,69,163,42.3,94,1424,395,27.7,407,657,360,124,21,0,103,134,302,137,3,Serie A,2021-2022,24325362613855847
33,Freiburg,23,10.0,164,93,77,62,25,77,173,44.5,96,1346,398,29.6,456,595,295,153,43,0,110,138,302,296,2,Bundesliga,2021-2022,17577284562417651
34,Genoa,30,11.0,205,126,100,80,25,78,178,43.8,100,1732,509,29.4,591,766,375,193,38,0,155,202,407,211,2,Serie A,2021-2022,87033800759594150
35,Getafe,26,12.0,224,143,105,87,32,85,207,41.1,122,2019,570,28.2,545,994,480,164,27,0,137,187,411,208,5,La Liga,2021-2022,23789167582387071
36,Granada,25,11.0,151,101,74,57,20,51,149,34.2,98,1348,375,27.8,457,647,244,162,45,3,117,133,284,264,4,La Liga,2021-2022,45137124328012624
37,Greuther Fürth,25,10.0,197,116,82,87,28,80,184,43.5,104,1598,489,30.6,503,743,352,157,39,0,118,146,343,241,2,Bundesliga,2021-2022,11035944553035865
38,Hellas Verona,24,11.0,177,116,86,66,25,58,154,37.7,96,1505,441,29.3,543,672,290,159,39,1,120,141,318,288,2,Serie A,2021-2022,45227680351245381
39,Hertha BSC,27,10.0,173,104,99,63,11,57,146,39.0,89,1585,461,29.1,615,705,265,176,36,1,140,155,328,286,1,Bundesliga,2021-2022,59737400018465050
40,Hoffenheim,22,10.0,180,112,78,81,21,69,159,43.4,90,1432,434,30.3,435,662,335,142,22,0,120,149,329,219,3,Bundesliga,2021-2022,29322720181807625
41,Inter,23,11.0,163,100,75,61,27,63,142,44.4,79,1403,399,28.4,434,606,363,142,36,1,106,117,280,187,3,Serie A,2021-2022,53198597771575973
42,Juventus,24,11.0,164,104,83,64,17,47,130,36.2,83,1454,462,31.8,532,624,298,158,45,1,113,132,296,224,6,Serie A,2021-2022,19371054131726661
43,Köln,22,10.0,195,117,86,74,35,86,214,40.2,128,1555,545,35.0,493,653,409,152,25,0,127,208,403,233,5,Bundesliga,2021-2022,39731782814123330
44,Lazio,23,11.0,190,101,84,75,31,66,182,36.3,116,1571,392,25.0,515,692,364,165,46,1,119,145,335,192,0,Serie A,2021-2022,90751438076496109
45,Leeds United,23,10.0,202,119,110,66,26,79,170,46.5,91,1602,491,30.6,552,682,368,147,46,1,101,142,344,235,6,Premier League,2021-2022,34570153325607342
46,Leicester City,22,10.0,182,105,79,84,19,76,175,43.4,99,1530,431,28.2,535,693,302,159,44,0,115,141,323,247,3,Premier League,2021-2022,18776461863573874
47,Lens,23,12.0,198,116,85,92,21,61,164,37.2,103,1728,503,29.1,487,840,401,158,38,1,120,184,382,186,2,Ligue 1,2021-2022,74951719010833888
48,Levante,26,12.0,187,122,97,63,27,56,147,38.1,91,1523,385,25.3,520,702,301,146,38,0,108,170,357,227,2,La Liga,2021-2022,1566092639264277
49,Leverkusen,23,10.0,186,113,102,73,11,75,175,42.9,100,1379,469,34.0,534,594,251,143,27,0,116,176,362,192,1,Bundesliga,2021-2022,36794408106212849
50,Lille,22,12.0,232,150,115,94,23,82,201,40.8,119,1657,494,29.8,526,757,374,167,34,0,133,170,402,225,1,Ligue 1,2021-2022,85603837513355486
51,Liverpool,24,10.0,146,91,52,65,29,52,137,38.0,85,1404,396,28.2,362,628,414,118,29,2,89,128,274,200,0,Premier League,2021-2022,41956650829873911
52,Lorient,25,12.0,230,147,112,91,27,90,241,37.3,151,1975,555,28.1,718,930,327,163,45,0,118,186,416,290,2,Ligue 1,2021-2022,37325341301512527
53,Lyon,25,12.0,245,156,115,95,35,104,240,43.3,136,1684,504,29.9,525,746,413,164,36,4,128,180,425,228,4,Ligue 1,2021-2022,87005642993871754
54,M'Gladbach,22,10.0,214,120,83,105,26,84,194,43.3,110,1504,495,32.9,380,735,389,152,24,0,128,148,362,177,0,Bundesliga,2021-2022,81611584009946193
55,Mainz 05,26,10.0,206,122,96,86,24,86,177,48.6,91,1696,523,30.8,533,753,410,192,33,1,159,142,348,237,5,Bundesliga,2021-2022,71158960989778912
56,Mallorca,27,12.0,211,137,112,85,14,57,163,35.0,106,1581,447,28.3,541,713,327,173,42,1,131,167,378,263,3,La Liga,2021-2022,96459977719332900
57,Manchester City,22,10.0,141,90,54,64,23,51,140,36.4,89,1182,357,30.2,267,535,380,116,28,2,88,112,253,166,3,Premier League,2021-2022,74026506610392765
58,Manchester Utd,21,10.0,132,82,55,53,24,43,127,33.9,84,1197,350,29.2,358,553,286,148,37,1,111,122,254,244,2,Premier League,2021-2022,29078730489839024
59,Marseille,23,12.0,192,119,89,84,19,65,163,39.9,98,1476,441,29.9,477,626,373,148,29,0,119,176,368,148,0,Ligue 1,2021-2022,66190039714113630
60,Metz,29,12.0,249,154,119,103,27,90,214,42.1,124,1916,584,30.5,669,882,365,206,50,3,156,223,472,240,3,Ligue 1,2021-2022,14635757597311544
61,Milan,26,11.0,197,120,95,73,29,68,146,46.6,78,1608,481,29.9,478,757,373,158,38,0,120,166,363,157,1,Serie A,2021-2022,59378513948613436
62,Monaco,25,12.0,282,176,112,145,25,108,244,44.3,136,1839,636,34.6,501,880,458,119,23,0,96,179,461,192,3,Ligue 1,2021-2022,79093238158793616
63,Montpellier,22,12.0,216,126,110,74,32,64,190,33.7,126,1717,507,29.5,579,741,397,138,34,0,104,186,402,192,0,Ligue 1,2021-2022,32434714471076965
64,Nantes,21,12.0,258,156,124,93,41,88,228,38.6,140,1923,512,26.6,632,872,419,159,37,2,122,201,459,236,2,Ligue 1,2021-2022,25802633648495862
65,Napoli,25,11.0,168,114,84,61,23,68,176,38.6,108,1481,449,30.3,438,626,417,153,33,1,120,108,276,155,0,Serie A,2021-2022,10516137814401134
66,Newcastle Utd,22,10.0,190,116,108,59,23,71,186,38.2,115,1381,394,28.5,576,552,253,168,53,1,115,128,318,227,1,Premier League,2021-2022,29528772732587842
67,Nice,23,12.0,238,137,108,100,30,87,204,42.6,117,1731,554,32.0,475,819,437,166,39,1,127,199,437,197,0,Ligue 1,2021-2022,11720969662561653
68,Norwich City,22,10.0,168,100,91,65,12,69,169,40.8,100,1562,378,24.2,653,610,299,178,60,2,118,154,322,249,2,Premier League,2021-2022,42809968147687487
69,Osasuna,26,12.0,192,109,84,80,28,74,184,40.2,110,1704,481,28.2,496,778,430,190,33,0,157,164,356,292,3,La Liga,2021-2022,83352675823776457
70,Paris S-G,27,12.0,200,121,73,82,45,69,202,34.2,133,1538,430,28.0,431,611,496,139,42,0,97,159,359,157,2,Ligue 1,2021-2022,11177590892093073
71,Rayo Vallecano,25,12.0,172,115,88,65,19,62,165,37.6,103,1808,501,27.7,588,822,398,193,42,0,151,179,351,235,1,La Liga,2021-2022,75203699329351977
72,RB Leipzig,23,10.0,174,109,61,90,23,59,142,41.5,83,1496,544,36.4,383,733,380,178,31,0,147,127,301,263,4,Bundesliga,2021-2022,68159208261559796
73,Real Madrid,25,11.0,182,115,90,64,28,51,155,32.9,104,1419,413,29.1,474,608,337,128,28,0,100,174,356,146,4,La Liga,2021-2022,29627131003986350
74,Real Sociedad,27,12.0,206,128,94,83,29,59,143,41.3,84,1623,503,31.0,468,730,425,162,32,0,130,125,331,256,3,La Liga,2021-2022,57299950304530590
75,Reims,25,12.0,231,143,120,89,22,76,171,44.4,95,1690,532,31.5,585,783,322,176,40,0,136,220,451,229,3,Ligue 1,2021-2022,67732085073987538
76,Rennes,26,12.0,184,108,78,66,40,85,189,45.0,104,1560,424,27.2,449,678,433,159,33,0,126,132,316,248,4,Ligue 1,2021-2022,96819424452761337
77,Roma,24,11.0,178,112,87,70,21,55,127,43.3,72,1557,434,27.9,506,678,373,131,22,1,109,133,311,162,3,Serie A,2021-2022,764736481564168
78,Saint-Étienne,28,12.0,262,161,116,117,29,73,207,35.3,134,1774,631,35.6,597,785,392,201,36,0,165,167,429,225,6,Ligue 1,2021-2022,56226069621228236
79,Salernitana,25,11.0,168,108,90,59,19,64,141,45.4,77,1423,392,27.5,551,559,313,186,53,1,133,140,308,236,1,Serie A,2021-2022,63444195793016658
80,Sampdoria,22,11.0,198,113,96,71,31,69,156,44.2,87,1627,446,27.4,540,692,395,166,42,1,124,175,373,211,3,Serie A,2021-2022,89407679695143145
81,Sassuolo,22,11.0,130,77,75,37,18,44,114,38.6,70,1435,386,26.9,464,648,323,161,40,6,121,132,262,199,7,Serie A,2021-2022,79200252522790650
82,Sevilla,26,11.0,173,117,75,79,19,46,125,36.8,79,1228,382,31.1,396,588,244,137,33,0,104,140,313,223,3,La Liga,2021-2022,22702270477938803
83,Southampton,21,10.0,187,117,82,69,36,67,176,38.1,109,1555,455,29.3,497,645,413,138,36,2,102,160,347,209,1,Premier League,2021-2022,21037626007536306
84,Spezia,26,11.0,179,110,83,66,30,65,169,38.5,104,1457,451,31.0,479,639,339,175,55,2,120,142,321,240,3,Serie A,2021-2022,41730244034743257
85,Strasbourg,23,12.0,241,140,117,87,37,91,206,44.2,115,1791,494,27.6,617,767,407,163,38,0,125,211,452,207,0,Ligue 1,2021-2022,92234479374253707
86,Stuttgart,28,10.0,186,112,82,84,20,67,154,43.5,87,1574,498,31.6,486,713,375,167,46,1,121,156,342,220,0,Bundesliga,2021-2022,81761661302668293
87,Torino,26,11.0,169,84,70,75,24,46,109,42.2,63,1620,520,32.1,465,743,412,145,28,0,117,155,324,238,3,Serie A,2021-2022,21846272194836439
88,Tottenham,21,10.0,200,110,96,82,22,63,167,37.7,104,1505,409,27.2,573,634,298,169,57,1,112,160,360,239,0,Premier League,2021-2022,22006624071753704
89,Troyes,28,12.0,208,119,115,75,18,71,192,37.0,121,1756,473,26.9,671,866,219,184,39,2,145,201,409,214,1,Ligue 1,2021-2022,57069542099991496
90,Udinese,21,11.0,191,128,100,69,22,65,157,41.4,92,1680,467,27.8,622,710,348,173,36,1,137,147,338,211,4,Serie A,2021-2022,48393495896639342
91,Union Berlin,23,10.0,169,89,91,60,18,63,159,39.6,96,1734,496,28.6,590,795,349,152,36,0,116,130,299,259,1,Bundesliga,2021-2022,71630543971501382
92,Valencia,26,12.0,198,118,91,78,29,68,164,41.5,96,1638,445,27.2,563,741,334,154,35,0,119,169,367,295,1,La Liga,2021-2022,65158650443085242
93,Venezia,29,11.0,194,120,99,67,28,73,166,44.0,93,1646,413,25.1,639,676,331,206,54,0,152,175,369,249,1,Serie A,2021-2022,94916874898547392
94,Villarreal,26,11.0,160,94,88,49,23,63,146,43.2,83,1279,400,31.3,465,507,307,159,39,2,120,134,294,195,4,La Liga,2021-2022,63335634096533483
95,Watford,26,10.0,167,94,100,55,12,62,169,36.7,107,1486,416,28.0,520,649,317,151,48,3,103,127,294,257,3,Premier League,2021-2022,73743918793554398
96,West Ham,18,10.0,185,114,92,63,30,62,148,41.9,86,1269,394,31.0,437,554,278,142,36,1,106,119,304,206,2,Premier League,2021-2022,57680956417459581
97,Wolfsburg,24,10.0,168,90,90,59,19,59,146,40.4,87,1468,463,31.5,481,632,355,138,25,0,113,153,321,235,3,Bundesliga,2021-2022,85159484018358879
98,Wolves,18,10.0,167,122,84,61,22,70,156,44.9,86,1211,372,30.7,451,509,251,120,30,0,90,140,307,244,2,Premier League,2021-2022,24001928852251903
1,Alavés,30,38.0,576,359,296,217,63,185,551,33.6,366,5451,1510,27.7,1750,2544,1157,570,105,4,465,430,1006,1064,9,La Liga,2020-2021,37745278530914180
2,Angers,31,38.0,718,460,337,303,78,238,728,32.7,490,6168,1795,29.1,2101,2848,1219,532,101,0,431,438,1156,855,8,Ligue 1,2020-2021,66587352409382849
3,Arminia,26,34.0,630,394,305,260,65,191,587,32.5,396,5767,1654,28.7,1889,2708,1170,622,131,2,491,303,933,936,9,Bundesliga,2020-2021,60726784699523350
4,Arsenal,29,38.0,510,315,242,194,74,175,516,33.9,341,4685,1331,28.4,1499,1897,1289,562,136,1,426,337,847,816,6,Premier League,2020-2021,5838645288327307
5,Aston Villa,24,38.0,590,358,268,234,88,203,557,36.4,354,5446,1473,27.0,1888,2277,1281,603,178,1,425,377,967,954,12,Premier League,2020-2021,14348480492050895
6,Atalanta,30,38.0,672,425,273,293,106,182,549,33.2,367,5673,1828,32.2,1497,2650,1526,539,93,3,446,501,1173,758,8,Serie A,2020-2021,87465877057901989
7,Athletic Club,27,38.0,523,343,235,227,61,158,551,28.7,393,5247,1450,27.6,1494,2377,1376,553,86,2,467,348,871,897,4,La Liga,2020-2021,4823083458145023
8,Atlético Madrid,25,38.0,704,449,346,267,91,288,671,42.9,383,5124,1540,30.1,1665,2328,1131,579,93,0,486,395,1099,797,3,La Liga,2020-2021,74713976168286555
9,Augsburg,25,34.0,579,338,272,244,63,192,544,35.3,352,5110,1524,29.8,1781,2376,953,646,127,3,519,437,1016,1016,12,Bundesliga,2020-2021,82828683183786310
10,Barcelona,25,38.0,548,351,240,226,82,206,513,40.2,307,5074,1547,30.5,1402,2331,1341,519,82,0,437,354,902,474,11,La Liga,2020-2021,81744823723090567
11,Bayern Munich,29,34.0,584,377,215,255,114,189,533,35.5,344,4986,1711,34.3,1244,2216,1526,534,82,0,452,415,999,549,7,Bundesliga,2020-2021,7510926916741648
12,Benevento,29,38.0,595,363,344,186,65,218,613,35.6,395,5031,1446,28.7,1971,2122,938,551,137,1,414,414,1009,846,13,Serie A,2020-2021,38159059008947812
13,Betis,25,38.0,605,378,289,240,76,196,557,35.2,361,5263,1514,28.8,1619,2495,1149,531,84,2,447,432,1037,855,10,La Liga,2020-2021,9423348454032625
14,Bologna,37,38.0,572,328,305,195,72,171,519,32.9,348,5460,1548,28.4,1944,2242,1274,653,153,2,500,446,1018,862,16,Serie A,2020-2021,23275147453355121
15,Bordeaux,28,38.0,615,413,328,224,63,223,624,35.7,401,5254,1546,29.4,1797,2417,1040,544,134,1,410,438,1053,830,9,Ligue 1,2020-2021,12683680850395737
16,Brest,26,38.0,697,436,386,258,53,216,580,37.2,364,5858,1659,28.3,2160,2500,1198,539,126,1,413,372,1069,931,8,Ligue 1,2020-2021,27328509848090670
17,Brighton,27,38.0,664,415,336,253,75,218,602,36.2,384,5179,1638,31.6,1732,2164,1283,579,121,3,458,395,1059,704,5,Premier League,2020-2021,49072214318111932
18,Burnley,25,38.0,562,320,267,211,84,201,551,36.5,350,4654,1282,27.5,1381,2041,1232,650,193,5,457,399,961,1035,8,Premier League,2020-2021,21823480134907726
19,Cádiz,34,38.0,611,385,337,218,56,222,623,35.6,401,5263,1433,27.2,2094,2303,866,612,118,4,494,411,1022,950,10,La Liga,2020-2021,1007679934589500
20,Cagliari,32,38.0,629,370,322,239,68,201,573,35.1,372,5752,1552,27.0,2095,2516,1141,574,148,1,426,379,1008,918,9,Serie A,2020-2021,32968728316179674
21,Celta Vigo,30,38.0,703,420,353,280,70,221,688,32.1,467,5997,1701,28.4,2063,2850,1084,610,97,1,513,375,1078,966,9,La Liga,2020-2021,14218303985450920
22,Chelsea,27,38.0,676,413,302,285,89,210,578,36.3,368,5376,1668,31.0,1692,2388,1296,582,100,1,482,444,1120,830,13,Premier League,2020-2021,58172670324373785
23,Crotone,31,38.0,602,373,333,195,74,198,535,37.0,337,5249,1477,28.1,2035,2190,1024,580,145,1,435,357,959,867,16,Serie A,2020-2021,33431629624225246
24,Crystal Palace,24,38.0,694,386,383,233,78,251,645,38.9,394,5700,1502,26.4,2314,2378,1008,659,151,2,508,460,1154,893,11,Premier League,2020-2021,15352059381074619
25,Dijon,33,38.0,691,440,380,253,58,250,686,36.4,436,5386,1561,29.0,1889,2517,980,543,125,4,418,509,1200,843,13,Ligue 1,2020-2021,59239312409540653
26,Dortmund,26,34.0,593,411,259,231,103,202,524,38.5,322,4787,1615,33.7,1412,2145,1230,518,110,1,408,401,994,629,7,Bundesliga,2020-2021,6921931827204601
27,Eibar,30,38.0,573,363,249,236,88,189,564,33.5,375,5005,1599,31.9,1274,2244,1487,552,75,2,477,385,958,963,8,La Liga,2020-2021,67267904110326262
28,Eint Frankfurt,25,34.0,664,408,319,254,91,232,659,35.2,427,5437,1696,31.2,1744,2400,1293,573,99,3,474,426,1090,699,10,Bundesliga,2020-2021,37929111009288632
29,Elche,30,38.0,598,394,346,213,39,193,608,31.7,415,5165,1455,28.2,2067,2226,872,553,111,2,442,388,986,866,8,La Liga,2020-2021,30674441257210497
30,Everton,29,38.0,684,426,380,232,72,240,653,36.8,413,5660,1604,28.3,2220,2364,1076,669,176,1,493,401,1085,927,11,Premier League,2020-2021,57482013681231466
31,Fiorentina,30,38.0,578,362,297,208,73,218,556,39.2,338,5179,1473,28.4,1814,2248,1117,510,139,1,371,368,946,773,6,Serie A,2020-2021,24325362613855847
32,Freiburg,24,34.0,500,298,224,206,70,142,504,28.2,362,5046,1356,26.9,1514,2323,1209,548,130,1,418,387,887,757,9,Bundesliga,2020-2021,17577284562417651
33,Fulham,28,38.0,671,415,312,263,96,216,561,38.5,345,5145,1537,29.9,1720,2157,1268,569,114,1,455,499,1170,1063,6,Premier League,2020-2021,19227944656237519
34,Genoa,34,38.0,641,393,338,224,79,214,587,36.5,373,5896,1550,26.3,2161,2538,1197,592,137,1,455,475,1116,981,12,Serie A,2020-2021,87033800759594150
35,Getafe,31,38.0,617,384,260,277,80,198,561,35.3,363,6119,1688,27.6,1616,3071,1432,553,68,4,485,424,1041,1142,7,La Liga,2020-2021,23789167582387071
36,Granada,34,38.0,569,375,278,226,65,190,513,37.0,323,5032,1359,27.0,1618,2347,1067,610,142,5,468,408,977,954,9,La Liga,2020-2021,45137124328012624
37,Hellas Verona,32,38.0,542,338,262,222,58,165,451,36.6,286,4976,1503,30.2,1580,2251,1145,594,169,1,425,463,1005,1015,16,Serie A,2020-2021,45227680351245381
38,Hertha BSC,32,34.0,585,352,316,207,62,180,525,34.3,345,5427,1585,29.2,1877,2387,1163,581,97,2,484,409,994,869,16,Bundesliga,2020-2021,59737400018465050
39,Hoffenheim,30,34.0,590,355,278,232,80,201,558,36.0,357,4769,1573,33.0,1429,2120,1220,560,105,5,455,346,936,759,10,Bundesliga,2020-2021,29322720181807625
40,Huesca,27,38.0,634,402,339,233,62,219,607,36.1,388,5451,1577,28.9,1951,2461,1039,550,103,1,447,349,983,775,6,La Liga,2020-2021,16593090704373522
41,Inter,25,38.0,541,326,249,205,87,178,492,36.2,314,5079,1434,28.2,1648,2069,1362,529,122,1,407,365,906,632,8,Serie A,2020-2021,53198597771575973
42,Juventus,30,38.0,626,395,285,251,90,193,557,34.6,364,5048,1517,30.1,1648,2183,1217,543,129,1,414,370,996,657,7,Serie A,2020-2021,19371054131726661
43,Köln,28,34.0,647,382,335,247,65,204,568,35.9,364,5101,1553,30.4,1831,2219,1051,558,113,3,445,427,1074,857,9,Bundesliga,2020-2021,39731782814123330
44,Lazio,30,38.0,656,395,318,257,81,231,696,33.2,465,5648,1751,31.0,1872,2504,1272,563,102,1,461,423,1079,755,7,Serie A,2020-2021,90751438076496109
45,Leeds United,23,38.0,825,493,437,297,91,274,798,34.3,524,6661,1972,29.6,2341,2885,1435,577,163,2,414,477,1302,791,13,Premier League,2020-2021,34570153325607342
46,Leicester City,27,38.0,734,445,347,286,101,227,633,35.9,406,5142,1629,31.7,1797,2214,1131,605,112,3,493,434,1168,844,4,Premier League,2020-2021,18776461863573874
47,Lens,27,38.0,703,404,312,304,87,225,568,39.6,343,4981,1558,31.3,1631,2269,1081,580,106,2,474,460,1163,907,8,Ligue 1,2020-2021,74951719010833888
48,Levante,29,38.0,573,368,289,216,68,200,603,33.2,403,5391,1500,27.8,1694,2365,1332,539,108,3,431,446,1019,993,13,La Liga,2020-2021,1566092639264277
49,Leverkusen,30,34.0,558,342,248,237,73,176,519,33.9,343,4792,1602,33.4,1344,2280,1168,516,98,3,418,377,935,677,5,Bundesliga,2020-2021,36794408106212849
50,Lille,21,38.0,702,452,304,294,104,247,680,36.3,433,5401,1629,30.2,1489,2518,1394,537,109,1,428,411,1113,798,5,Ligue 1,2020-2021,85603837513355486
51,Liverpool,28,38.0,560,358,221,233,106,197,562,35.1,365,5394,1707,31.6,1339,2329,1726,504,77,4,427,385,945,769,21,Premier League,2020-2021,41956650829873911
52,Lorient,27,38.0,803,482,389,342,72,287,828,34.7,541,5681,1642,28.9,1998,2712,971,571,135,2,436,482,1285,927,5,Ligue 1,2020-2021,37325341301512527
53,Lyon,29,38.0,695,449,297,287,111,229,641,35.7,412,5012,1543,30.8,1465,2237,1310,547,135,4,412,402,1097,758,16,Ligue 1,2020-2021,87005642993871754
54,M'Gladbach,23,34.0,560,346,257,235,68,213,600,35.5,387,4811,1432,29.8,1391,2265,1155,610,133,4,477,455,1015,833,6,Bundesliga,2020-2021,81611584009946193
55,Mainz 05,31,34.0,688,405,329,256,103,208,592,35.1,384,5385,1686,31.3,1727,2411,1247,584,127,2,457,454,1142,941,9,Bundesliga,2020-2021,71158960989778912
56,Manchester City,24,38.0,554,365,222,228,104,214,610,35.1,396,4560,1462,32.1,1167,2030,1363,438,97,0,341,339,893,585,6,Premier League,2020-2021,74026506610392765
57,Manchester Utd,29,38.0,590,371,283,227,80,191,553,34.5,362,5041,1490,29.6,1537,2164,1340,608,135,0,473,455,1045,806,7,Premier League,2020-2021,29078730489839024
58,Marseille,31,38.0,778,468,357,315,106,301,744,40.5,443,5256,1609,30.6,1721,2412,1123,547,118,0,429,427,1205,880,7,Ligue 1,2020-2021,66190039714113630
59,Metz,27,38.0,770,462,428,275,67,273,724,37.7,451,5416,1658,30.6,1987,2444,985,597,128,5,469,450,1220,1037,13,Ligue 1,2020-2021,14635757597311544
60,Milan,29,38.0,679,406,345,258,76,257,614,41.9,357,5848,1718,29.4,1928,2655,1265,645,153,4,492,383,1062,816,11,Serie A,2020-2021,59378513948613436
61,Monaco,30,38.0,844,551,358,368,118,272,704,38.6,432,5552,1822,32.8,1526,2717,1309,508,80,0,428,393,1237,730,7,Ligue 1,2020-2021,79093238158793616
62,Montpellier,25,38.0,646,400,375,209,62,269,740,36.4,471,4838,1420,29.4,1812,2069,957,556,160,3,396,396,1042,849,10,Ligue 1,2020-2021,32434714471076965
63,Nantes,25,38.0,790,454,399,304,87,297,752,39.5,455,5726,1774,31.0,1928,2653,1145,595,130,5,465,418,1208,957,10,Ligue 1,2020-2021,25802633648495862
64,Napoli,25,38.0,620,391,299,243,78,218,625,34.9,407,5074,1496,29.5,1608,2109,1357,527,115,1,412,407,1027,633,9,Serie A,2020-2021,10516137814401134
65,Newcastle Utd,27,38.0,607,363,317,233,57,205,586,35.0,381,5423,1346,24.8,2148,2247,1028,641,173,5,468,415,1022,1038,13,Premier League,2020-2021,29528772732587842
66,Nice,31,38.0,677,425,328,265,84,268,667,40.2,399,5055,1470,29.1,1679,2165,1211,528,132,0,396,380,1057,792,13,Ligue 1,2020-2021,11720969662561653
67,Nîmes,33,38.0,712,433,354,260,98,279,765,36.5,486,6109,1756,28.7,2127,2742,1240,649,141,0,508,475,1187,896,13,Ligue 1,2020-2021,83514802313158576
68,Osasuna,28,38.0,569,354,255,236,78,204,536,38.1,332,5329,1549,29.1,1558,2487,1284,557,109,2,448,384,953,1027,3,La Liga,2020-2021,83352675823776457
69,Paris S-G,33,38.0,664,427,255,294,115,249,692,36.0,443,4912,1551,31.6,1265,2138,1509,491,91,1,400,364,1028,567,15,Ligue 1,2020-2021,11177590892093073
70,Parma,42,38.0,636,369,359,221,56,232,648,35.8,416,5566,1486,26.7,2162,2369,1035,596,127,1,469,430,1066,863,10,Serie A,2020-2021,62695319081093388
71,RB Leipzig,25,34.0,586,352,233,265,88,157,482,32.6,325,5271,1778,33.7,1227,2523,1521,503,76,0,427,380,966,676,6,Bundesliga,2020-2021,68159208261559796
72,Real Madrid,30,38.0,572,353,285,211,76,184,552,33.3,368,4880,1425,29.2,1562,2175,1143,535,100,4,435,406,978,667,9,La Liga,2020-2021,29627131003986350
73,Real Sociedad,30,38.0,560,342,251,235,74,172,529,32.5,357,5070,1487,29.3,1423,2340,1307,497,104,2,393,337,897,859,5,La Liga,2020-2021,57299950304530590
74,Reims,29,38.0,723,432,371,262,90,168,570,29.5,402,5369,1493,27.8,1999,2247,1123,530,134,6,396,438,1161,873,11,Ligue 1,2020-2021,67732085073987538
75,Rennes,32,38.0,684,455,289,294,101,198,572,34.6,374,5237,1622,31.0,1450,2376,1411,497,94,2,403,340,1024,742,8,Ligue 1,2020-2021,96819424452761337
76,Roma,31,38.0,558,390,225,257,76,163,568,28.7,405,5570,1599,28.7,1614,2644,1312,499,98,3,401,457,1015,647,12,Serie A,2020-2021,764736481564168
77,Saint-Étienne,40,38.0,803,496,446,268,89,258,713,36.2,455,5927,1827,30.8,1917,2633,1377,557,105,2,452,447,1250,891,16,Ligue 1,2020-2021,56226069621228236
78,Sampdoria,27,38.0,637,398,306,262,69,186,598,31.1,412,6173,1763,28.6,1989,2707,1477,662,170,5,492,409,1046,859,10,Serie A,2020-2021,89407679695143145
79,Sassuolo,28,38.0,594,369,301,188,105,197,515,38.3,318,4943,1515,30.6,1571,2027,1345,575,158,2,417,372,966,762,8,Serie A,2020-2021,79200252522790650
80,Schalke 04,42,34.0,626,375,326,242,58,196,582,33.7,386,5325,1572,29.5,2032,2328,965,617,160,2,457,467,1093,789,10,Bundesliga,2020-2021,24345039935475884
81,Sevilla,26,38.0,571,389,253,242,76,200,546,36.6,346,4716,1477,31.3,1392,2199,1125,503,95,3,408,334,905,767,8,La Liga,2020-2021,22702270477938803
82,Sheffield Utd,27,38.0,669,368,346,252,71,248,713,34.8,465,6123,1518,24.8,2080,2631,1412,630,165,9,465,440,1109,1015,19,Premier League,2020-2021,93216768512646707
83,Southampton,29,38.0,784,455,380,319,85,296,747,39.6,451,5714,1783,31.2,1970,2500,1244,624,111,1,513,435,1219,855,10,Premier League,2020-2021,21037626007536306
84,Spezia,35,38.0,630,386,289,258,83,215,564,38.1,349,5325,1607,30.2,1594,2456,1275,530,106,2,424,436,1066,744,16,Serie A,2020-2021,41730244034743257
85,Strasbourg,26,38.0,719,472,370,259,90,214,585,36.6,371,5307,1665,31.4,1850,2374,1083,516,95,5,421,512,1231,821,11,Ligue 1,2020-2021,92234479374253707
86,Stuttgart,29,34.0,570,350,288,207,75,205,555,36.9,350,4667,1442,30.9,1539,1923,1205,601,129,3,472,382,952,777,6,Bundesliga,2020-2021,81761661302668293
87,Torino,29,38.0,595,377,284,224,87,215,577,37.3,362,5180,1495,28.9,1789,2256,1135,554,134,5,420,493,1088,882,11,Serie A,2020-2021,21846272194836439
88,Tottenham,24,38.0,694,425,349,261,84,257,689,37.3,432,5871,1643,28.0,2124,2563,1184,582,160,2,422,370,1064,1010,4,Premier League,2020-2021,22006624071753704
89,Udinese,33,38.0,592,383,325,213,54,207,579,35.8,372,5073,1450,28.6,2030,1990,1053,619,155,1,464,399,991,782,15,Serie A,2020-2021,48393495896639342
90,Union Berlin,27,34.0,585,349,298,230,57,189,502,37.6,313,4970,1580,31.8,1641,2370,959,529,104,2,425,428,1013,775,9,Bundesliga,2020-2021,71630543971501382
91,Valencia,30,38.0,508,312,259,183,66,187,574,32.6,387,4857,1305,26.9,1794,2068,995,566,137,2,429,321,829,951,14,La Liga,2020-2021,65158650443085242
92,Valladolid,32,38.0,619,376,341,208,70,224,676,33.1,452,5923,1644,27.8,2062,2650,1211,609,117,2,492,390,1009,991,9,La Liga,2020-2021,44089518275887893
93,Villarreal,29,38.0,566,340,253,242,71,177,580,30.5,403,4994,1425,28.5,1587,2226,1181,578,117,3,461,354,920,777,8,La Liga,2020-2021,63335634096533483
94,Werder Bremen,27,34.0,608,375,306,223,79,197,573,34.4,376,5537,1585,28.6,1949,2431,1157,609,113,0,496,477,1085,954,6,Bundesliga,2020-2021,59303898890876434
95,West Brom,30,38.0,662,398,365,226,71,227,650,34.9,423,5494,1530,27.8,2120,2269,1105,679,172,9,507,447,1109,1025,12,Premier League,2020-2021,26775906631723373
96,West Ham,24,38.0,559,346,308,197,54,190,614,30.9,424,4989,1342,26.9,1882,2133,974,603,143,4,460,426,985,988,9,Premier League,2020-2021,57680956417459581
97,Wolfsburg,26,34.0,710,430,336,296,78,240,626,38.3,386,5829,1939,33.3,1707,2617,1505,622,96,3,526,461,1171,891,9,Bundesliga,2020-2021,85159484018358879
98,Wolves,27,38.0,618,398,351,204,63,228,621,36.7,393,5195,1558,30.0,2105,2187,903,539,133,5,406,388,1006,898,6,Premier League,2020-2021,24001928852251903
1,Alavés,32,38.0,613,370,295,269,49,194,580,33.4,386,5609,1464,26.1,1757,2820,1032,576,120,0,456,214,827,1085,8,La Liga,2019-2020,37745278530914180
2,Amiens,27,28.0,482,318,227,211,44,183,554,33.0,371,4988,1362,27.3,1550,2448,990,467,112,3,355,273,755,861,9,Ligue 1,2019-2020,20069478421376018
3,Angers,26,28.0,502,320,230,209,63,172,557,30.9,385,5169,1427,27.6,1640,2532,997,421,59,1,362,236,738,690,8,Ligue 1,2019-2020,66587352409382849
4,Arsenal,29,38.0,601,373,325,199,77,202,596,33.9,394,6127,1640,26.8,2245,2662,1220,614,153,2,461,244,845,978,14,Premier League,2019-2020,5838645288327307
5,Aston Villa,28,38.0,606,388,339,194,73,192,613,31.3,421,5837,1595,27.3,2133,2485,1219,725,213,4,512,254,860,983,29,Premier League,2019-2020,14348480492050895
6,Atalanta,30,38.0,702,445,313,294,95,290,775,37.4,485,5978,1870,31.3,1674,2939,1365,607,125,3,482,252,954,847,9,Serie A,2019-2020,87465877057901989
7,Athletic Club,26,38.0,578,353,286,219,73,191,618,30.9,427,5431,1547,28.5,1706,2478,1247,573,99,2,474,238,816,1130,8,La Liga,2019-2020,4823083458145023
8,Atlético Madrid,30,38.0,670,431,310,272,88,261,682,38.3,421,5111,1532,30.0,1616,2385,1110,659,124,1,535,221,891,990,6,La Liga,2019-2020,74713976168286555
9,Augsburg,28,34.0,549,331,276,212,61,190,632,30.1,442,5650,1440,25.5,1794,2622,1234,574,137,7,437,283,832,971,7,Bundesliga,2019-2020,82828683183786310
10,Barcelona,28,38.0,545,368,224,228,93,166,462,35.9,296,4843,1487,30.7,1268,2305,1270,493,93,4,400,239,784,638,9,La Liga,2019-2020,81744823723090567
11,Bayern Munich,29,34.0,552,368,193,256,103,186,555,33.5,369,4904,1702,34.7,1119,2168,1617,462,89,1,373,220,772,565,3,Bundesliga,2019-2020,7510926916741648
12,Betis,27,38.0,534,331,285,190,59,160,495,32.3,335,4932,1308,26.5,1590,2228,1114,562,141,1,421,208,742,941,5,La Liga,2019-2020,9423348454032625
13,Bologna,31,38.0,619,399,283,257,79,231,691,33.4,460,6612,1852,28.0,2121,2948,1543,654,143,6,511,257,876,952,15,Serie A,2019-2020,23275147453355121
14,Bordeaux,26,28.0,539,347,265,219,55,196,574,34.1,378,4720,1387,29.4,1379,2361,980,418,101,0,317,227,766,705,5,Ligue 1,2019-2020,12683680850395737
15,Bournemouth,27,38.0,559,349,279,220,60,184,582,31.6,398,6790,1780,26.2,2224,2967,1599,703,176,3,527,288,847,1135,14,Premier League,2019-2020,36088947257895306
16,Brescia,32,38.0,586,353,309,222,55,224,665,33.7,441,6516,1522,23.4,2419,2715,1382,701,196,3,505,245,831,963,14,Serie A,2019-2020,24926529561002350
17,Brest,24,28.0,554,356,268,222,64,165,506,32.6,341,4469,1284,28.7,1527,2015,927,452,97,2,355,246,800,759,10,Ligue 1,2019-2020,27328509848090670
18,Brighton,25,38.0,663,409,339,237,87,214,644,33.2,430,5794,1743,30.1,2018,2419,1357,631,162,5,469,299,962,934,16,Premier League,2019-2020,49072214318111932
19,Burnley,22,38.0,583,340,264,239,80,204,612,33.3,408,5802,1482,25.5,1782,2535,1485,712,189,3,523,252,835,1234,5,Premier League,2019-2020,21823480134907726
20,Cagliari,33,38.0,638,409,331,236,71,219,672,32.6,453,5313,1481,27.9,2100,2194,1019,656,200,3,456,255,893,921,10,Serie A,2019-2020,32968728316179674
21,Celta Vigo,30,38.0,619,371,351,217,51,191,563,33.9,372,5389,1542,28.6,2040,2314,1035,521,102,0,419,263,882,985,4,La Liga,2019-2020,14218303985450920
22,Chelsea,27,38.0,739,449,351,296,92,217,626,34.7,409,6197,1916,30.9,1812,2841,1544,576,102,2,474,268,1007,930,9,Premier League,2019-2020,58172670324373785
23,Crystal Palace,25,38.0,733,430,393,264,76,260,678,38.3,418,6252,1698,27.2,2430,2645,1177,675,153,3,522,277,1010,999,13,Premier League,2019-2020,15352059381074619
24,Dijon,28,28.0,583,360,293,222,68,198,548,36.1,350,4745,1347,28.4,1625,2254,866,431,110,1,321,256,839,751,7,Ligue 1,2019-2020,59239312409540653
25,Dortmund,27,34.0,596,401,276,250,70,221,551,40.1,330,5195,1676,32.3,1475,2388,1332,519,106,4,413,286,882,604,11,Bundesliga,2019-2020,6921931827204601
26,Düsseldorf,28,34.0,555,347,283,211,61,203,591,34.3,388,5503,1614,29.3,1787,2600,1116,558,118,4,440,302,857,759,10,Bundesliga,2019-2020,6414184432322702
27,Eibar,26,38.0,618,370,263,255,100,216,622,34.7,406,5515,1618,29.3,1386,2572,1557,580,96,3,484,264,882,1046,7,La Liga,2019-2020,67267904110326262
28,Eint Frankfurt,27,34.0,679,444,311,289,79,207,630,32.9,423,5909,1837,31.1,1890,2636,1383,584,110,6,474,251,930,761,5,Bundesliga,2019-2020,37929111009288632
29,Espanyol,31,38.0,640,402,321,254,65,237,685,34.6,448,5907,1660,28.1,1928,2845,1134,551,98,1,453,251,891,1003,8,La Liga,2019-2020,71314269182841176
30,Everton,24,38.0,739,423,369,267,103,245,736,33.3,491,6067,1659,27.3,2068,2639,1360,588,130,1,458,279,1018,1037,10,Premier League,2019-2020,57482013681231466
31,Fiorentina,33,38.0,635,401,349,211,75,184,651,28.3,467,5944,1627,27.4,1968,2584,1392,561,119,0,442,263,898,915,7,Serie A,2019-2020,24325362613855847
32,Freiburg,26,34.0,514,309,264,190,60,141,507,27.8,366,4807,1268,26.4,1675,2068,1064,564,170,3,394,255,769,1027,12,Bundesliga,2019-2020,17577284562417651
33,Genoa,34,38.0,616,391,315,224,77,184,606,30.4,422,6088,1650,27.1,2197,2628,1263,622,163,1,459,311,927,861,12,Serie A,2019-2020,87033800759594150
34,Getafe,30,38.0,644,391,260,294,90,203,580,35.0,377,6261,1865,29.8,1633,3179,1449,526,72,2,454,269,913,1145,4,La Liga,2019-2020,23789167582387071
35,Granada,27,38.0,590,351,258,264,68,183,532,34.4,349,5811,1577,27.1,1731,2884,1196,588,126,0,462,214,804,1005,4,La Liga,2019-2020,45137124328012624
36,Hellas Verona,30,38.0,549,345,271,209,69,185,544,34.0,359,5569,1634,29.3,2001,2324,1244,597,190,3,407,279,828,1035,9,Serie A,2019-2020,45227680351245381
37,Hertha BSC,32,34.0,613,356,313,230,70,190,580,32.8,390,5758,1570,27.3,2030,2530,1198,651,142,4,509,304,917,986,17,Bundesliga,2019-2020,59737400018465050
38,Hoffenheim,31,34.0,590,353,335,200,55,225,585,38.5,360,4665,1377,29.5,1663,1976,1026,595,141,5,454,263,853,860,4,Bundesliga,2019-2020,29322720181807625
39,Inter,29,38.0,576,373,239,246,91,200,633,31.6,433,5524,1513,27.4,1697,2372,1455,600,141,2,459,260,836,741,6,Serie A,2019-2020,53198597771575973
40,Juventus,30,38.0,624,382,273,232,119,208,597,34.8,389,5218,1480,28.4,1400,2341,1477,608,143,4,465,269,893,709,15,Serie A,2019-2020,19371054131726661
41,Köln,29,34.0,670,421,348,254,68,213,586,36.3,373,6341,1829,28.8,2141,2855,1345,593,113,2,480,272,942,947,4,Bundesliga,2019-2020,39731782814123330
42,Lazio,27,38.0,641,404,316,246,79,218,693,31.5,475,5603,1601,28.6,2018,2338,1247,582,160,2,422,244,885,765,8,Serie A,2019-2020,90751438076496109
43,Lecce,30,38.0,575,385,309,201,65,211,682,30.9,471,5378,1345,25.0,2150,2234,994,625,170,5,455,266,841,894,12,Serie A,2019-2020,92912790925867566
44,Leganés,29,38.0,640,389,339,230,71,221,603,36.7,382,5723,1585,27.7,1855,2620,1248,543,79,1,464,249,889,1063,4,La Liga,2019-2020,20237473683555152
45,Leicester City,24,38.0,781,478,381,311,89,283,786,36.0,503,6392,1984,31.0,2112,2895,1385,601,107,2,494,309,1090,1013,13,Premier League,2019-2020,18776461863573874
46,Levante,29,38.0,548,319,301,190,57,185,543,34.1,358,4990,1312,26.3,1706,2244,1040,539,119,0,420,264,812,1005,7,La Liga,2019-2020,1566092639264277
47,Leverkusen,24,34.0,614,382,274,263,77,219,605,36.2,386,5211,1775,34.1,1533,2440,1238,553,93,2,460,246,860,750,9,Bundesliga,2019-2020,36794408106212849
48,Lille,25,28.0,497,324,203,235,59,209,569,36.7,360,4780,1432,30.0,1246,2292,1242,388,71,2,317,196,693,661,4,Ligue 1,2019-2020,85603837513355486
49,Liverpool,24,38.0,606,375,225,258,123,212,607,34.9,395,5638,1813,32.2,1496,2346,1796,481,75,2,406,246,852,863,10,Premier League,2019-2020,41956650829873911
50,Lyon,27,28.0,521,330,277,183,61,165,445,37.1,280,4267,1253,29.4,1434,1858,975,393,107,0,286,215,736,654,6,Ligue 1,2019-2020,87005642993871754
51,M'Gladbach,25,34.0,630,400,290,260,80,216,626,34.5,410,5702,1687,29.6,1688,2620,1394,604,120,2,484,269,899,712,11,Bundesliga,2019-2020,81611584009946193
52,Mainz 05,25,34.0,630,386,304,263,63,201,572,35.1,371,6081,1663,27.3,1935,2851,1295,625,131,4,494,296,926,959,13,Bundesliga,2019-2020,71158960989778912
53,Mallorca,32,38.0,607,389,324,225,58,215,592,36.3,377,5626,1526,27.1,2031,2512,1083,561,125,1,436,242,849,776,8,La Liga,2019-2020,96459977719332900
54,Manchester City,24,38.0,567,365,224,230,113,228,638,35.7,410,5003,1584,31.7,1187,2160,1656,444,74,3,370,227,794,655,19,Premier League,2019-2020,74026506610392765
55,Manchester Utd,29,38.0,618,359,292,245,81,207,626,33.1,419,5860,1650,28.2,1883,2616,1361,632,117,0,515,300,918,880,7,Premier League,2019-2020,29078730489839024
56,Marseille,23,28.0,604,372,280,254,70,222,607,36.6,385,4467,1277,28.6,1207,2154,1106,413,71,0,342,192,796,701,6,Ligue 1,2019-2020,66190039714113630
57,Metz,24,28.0,608,385,351,210,47,200,520,38.5,320,5067,1352,26.7,1828,2378,861,470,107,0,363,252,860,802,5,Ligue 1,2019-2020,14635757597311544
58,Milan,32,38.0,648,411,305,260,83,206,652,31.6,446,6213,1744,28.1,1927,2840,1446,574,121,3,453,324,972,696,12,Serie A,2019-2020,59378513948613436
59,Monaco,28,28.0,566,356,256,252,58,191,567,33.7,376,4704,1404,29.8,1437,2178,1089,401,82,1,319,262,828,601,10,Ligue 1,2019-2020,79093238158793616
60,Montpellier,27,28.0,473,294,236,187,50,205,589,34.8,384,4425,1247,28.2,1447,2000,978,383,93,2,290,216,689,722,2,Ligue 1,2019-2020,32434714471076965
61,Nantes,29,28.0,605,371,293,257,55,254,611,41.6,357,4814,1343,27.9,1460,2297,1057,364,81,1,283,224,829,784,3,Ligue 1,2019-2020,25802633648495862
62,Napoli,25,38.0,576,377,260,226,90,216,597,36.2,381,5574,1572,28.2,1549,2425,1600,536,104,5,432,192,768,566,9,Serie A,2019-2020,10516137814401134
63,Newcastle Utd,28,38.0,672,393,413,198,61,225,622,36.2,397,5994,1524,25.4,2591,2401,1002,638,173,5,465,293,965,1133,11,Premier League,2019-2020,29528772732587842
64,Nice,31,28.0,511,302,282,171,58,197,552,35.7,355,4486,1188,26.5,1495,1933,1058,417,95,0,322,253,764,545,7,Ligue 1,2019-2020,11720969662561653
65,Nîmes,28,28.0,562,336,264,230,68,225,662,34.0,437,4386,1319,30.1,1431,2043,912,411,82,1,329,248,810,723,3,Ligue 1,2019-2020,83514802313158576
66,Norwich City,30,38.0,716,434,419,219,78,253,776,32.6,523,6492,1779,27.4,2695,2609,1188,713,197,6,516,270,986,1039,16,Premier League,2019-2020,42809968147687487
67,Osasuna,31,38.0,641,389,297,278,66,225,596,37.8,371,5491,1662,30.3,1525,2722,1244,611,105,2,506,255,896,1117,15,La Liga,2019-2020,83352675823776457
68,Paderborn 07,27,34.0,690,409,386,242,62,297,796,37.3,499,6339,1805,28.5,2114,2783,1442,676,134,4,542,262,952,888,9,Bundesliga,2019-2020,13210847894253626
69,Paris S-G,31,27.0,530,316,212,224,94,194,557,34.8,363,4054,1252,30.9,1064,1826,1164,366,74,1,292,185,715,363,9,Ligue 1,2019-2020,11177590892093073
70,Parma,25,38.0,644,405,350,230,64,244,741,32.9,497,6213,1645,26.5,2482,2604,1127,683,200,1,483,264,908,971,10,Serie A,2019-2020,62695319081093388
71,RB Leipzig,29,34.0,659,420,290,278,91,242,661,36.6,419,5924,1939,32.7,1690,2876,1358,577,98,2,479,262,921,746,13,Bundesliga,2019-2020,68159208261559796
72,Real Madrid,26,38.0,625,415,272,267,86,207,597,34.7,390,5071,1507,29.7,1469,2469,1133,562,88,3,474,284,909,603,14,La Liga,2019-2020,29627131003986350
73,Real Sociedad,27,38.0,584,362,259,260,65,221,598,37.0,377,5055,1496,29.6,1450,2411,1194,528,89,1,439,226,810,971,6,La Liga,2019-2020,57299950304530590
74,Reims,26,28.0,551,345,288,205,58,184,481,38.3,297,4141,1231,29.7,1395,1880,866,385,82,0,303,228,779,744,7,Ligue 1,2019-2020,67732085073987538
75,Rennes,26,28.0,548,338,267,227,54,180,564,31.9,384,4472,1279,28.6,1420,2145,907,437,115,1,322,188,736,792,10,Ligue 1,2019-2020,96819424452761337
76,Roma,31,38.0,551,341,239,215,97,175,539,32.5,364,5080,1461,28.8,1592,2332,1156,531,117,2,414,235,786,771,19,Serie A,2019-2020,764736481564168
77,Saint-Étienne,31,28.0,585,378,251,260,74,198,532,37.2,334,4712,1434,30.4,1276,2401,1035,407,78,4,329,276,861,678,8,Ligue 1,2019-2020,56226069621228236
78,Sampdoria,31,38.0,651,411,300,256,95,218,668,32.6,450,5978,1563,26.1,1910,2725,1343,622,130,2,492,288,939,902,11,Serie A,2019-2020,89407679695143145
79,Sassuolo,31,38.0,638,394,312,231,95,222,589,37.7,367,5467,1625,29.7,1882,2271,1314,619,151,2,468,248,886,678,12,Serie A,2019-2020,79200252522790650
80,Schalke 04,29,34.0,691,430,312,284,95,248,693,35.8,445,6110,1887,30.9,1886,2771,1453,611,132,2,479,306,997,841,10,Bundesliga,2019-2020,24345039935475884
81,Sevilla,26,38.0,614,398,293,259,62,265,670,39.6,405,5071,1540,30.4,1522,2421,1128,519,110,3,409,208,822,1003,9,La Liga,2019-2020,22702270477938803
82,Sheffield Utd,26,38.0,652,392,339,230,83,211,642,32.9,431,6367,1766,27.7,2135,2706,1526,618,125,2,493,260,912,1244,12,Premier League,2019-2020,93216768512646707
83,Southampton,25,38.0,791,484,374,310,107,291,859,33.9,568,6825,2107,30.9,2195,2917,1713,693,147,0,546,295,1086,1276,20,Premier League,2019-2020,21037626007536306
84,SPAL,34,38.0,604,356,319,212,73,196,591,33.2,395,5605,1450,25.9,1970,2458,1177,579,182,4,397,250,854,893,13,Serie A,2019-2020,73622612860183040
85,Strasbourg,25,27.0,524,337,263,208,53,180,460,39.1,280,4358,1302,29.9,1514,1979,865,348,63,2,285,245,769,633,8,Ligue 1,2019-2020,92234479374253707
86,Torino,27,38.0,661,401,335,248,78,215,611,35.2,396,5723,1536,26.8,2068,2422,1233,715,186,0,529,339,1000,1059,13,Serie A,2019-2020,21846272194836439
87,Tottenham,29,38.0,709,445,353,294,62,213,689,30.9,476,6209,1752,28.2,2286,2733,1190,660,168,2,492,259,968,1074,11,Premier League,2019-2020,22006624071753704
88,Toulouse,30,28.0,560,393,295,219,46,204,536,38.1,332,4580,1285,28.1,1681,2048,851,448,97,2,351,238,798,717,14,Ligue 1,2019-2020,94523000561782573
89,Udinese,25,38.0,655,395,363,222,70,242,666,36.3,424,6284,1674,26.6,2494,2594,1196,652,183,0,469,264,919,870,9,Serie A,2019-2020,48393495896639342
90,Union Berlin,26,34.0,629,369,325,239,65,214,638,33.5,424,5859,1672,28.5,1882,2780,1197,638,145,1,493,287,916,1093,3,Bundesliga,2019-2020,71630543971501382
91,Valencia,28,38.0,507,339,264,189,54,182,575,31.7,393,5278,1356,25.7,1909,2304,1065,546,139,1,407,221,728,956,10,La Liga,2019-2020,65158650443085242
92,Valladolid,30,38.0,616,400,349,224,43,212,677,31.3,465,5770,1529,26.5,2084,2688,998,624,123,2,501,268,884,1014,13,La Liga,2019-2020,44089518275887893
93,Villarreal,25,38.0,575,358,261,258,56,214,625,34.2,411,5610,1540,27.5,1816,2770,1024,591,128,1,463,213,788,992,8,La Liga,2019-2020,63335634096533483
94,Watford,26,38.0,681,429,353,245,83,238,777,30.6,539,6798,1847,27.2,2334,2978,1486,621,155,5,466,313,994,1101,12,Premier League,2019-2020,73743918793554398
95,Werder Bremen,30,34.0,636,397,315,238,83,227,633,35.9,406,5846,1675,28.7,2091,2543,1212,580,131,1,449,279,915,969,10,Bundesliga,2019-2020,59303898890876434
96,West Ham,29,38.0,720,470,400,253,67,230,763,30.1,533,6464,1795,27.8,2438,2785,1241,633,127,1,506,291,1011,929,11,Premier League,2019-2020,57680956417459581
97,Wolfsburg,26,34.0,653,401,316,259,78,242,693,34.9,451,6106,1946,31.9,1715,2861,1530,590,96,2,494,281,934,896,12,Bundesliga,2019-2020,85159484018358879
98,Wolves,21,38.0,716,423,398,254,64,266,730,36.4,464,6251,1710,27.4,2387,2810,1054,608,128,1,480,263,979,972,13,Premier League,2019-2020,24001928852251903
1,Alavés,26,38.0,636,365,329,234,73,226,659,34.3,433,5867,1386,23.6,1963,2755,1149,606,116,2,490,343,979,1148,8,La Liga,2018-2019,37745278530914180
2,Amiens,26,38.0,657,454,323,258,76,206,700,29.4,494,6108,1597,26.1,2073,2827,1208,603,146,2,457,263,920,984,4,Ligue 1,2018-2019,20069478421376018
3,Angers,24,38.0,665,452,353,237,75,229,803,28.5,574,7461,1866,25.0,2742,3644,1075,593,119,2,474,365,1030,882,5,Ligue 1,2018-2019,66587352409382849
4,Arsenal,28,38.0,626,404,300,250,76,197,578,34.1,381,5785,1674,28.9,1839,2713,1233,550,129,2,421,385,1011,955,11,Premier League,2018-2019,5838645288327307
5,Atalanta,27,38.0,708,470,337,284,87,286,718,39.8,432,5905,1777,30.1,1747,2780,1378,575,104,2,471,405,1113,749,9,Serie A,2018-2019,87465877057901989
6,Athletic Club,27,38.0,644,423,314,239,91,213,730,29.2,517,5861,1531,26.1,1720,2781,1360,576,96,1,480,351,995,986,8,La Liga,2018-2019,4823083458145023
7,Atlético Madrid,29,38.0,784,523,416,297,71,258,743,34.7,485,6995,1814,25.9,2216,3295,1484,582,104,1,478,361,1145,830,10,La Liga,2018-2019,74713976168286555
8,Augsburg,30,34.0,582,372,284,232,66,178,539,33.0,361,5481,1372,25.0,1739,2535,1207,558,140,5,418,293,875,796,5,Bundesliga,2018-2019,82828683183786310
9,Barcelona,30,38.0,572,391,239,248,85,211,563,37.5,352,6225,1796,28.9,1647,2961,1617,586,110,2,476,288,860,584,7,La Liga,2018-2019,81744823723090567
10,Bayern Munich,24,34.0,474,320,184,210,80,140,445,31.5,305,4461,1420,31.8,1043,2036,1382,426,75,3,351,215,689,418,6,Bundesliga,2018-2019,7510926916741648
11,Betis,25,38.0,622,420,311,240,71,191,601,31.8,410,5208,1385,26.6,1751,2310,1147,512,87,2,425,259,881,653,13,La Liga,2018-2019,9423348454032625
12,Bologna,29,38.0,692,420,379,235,78,241,675,35.7,434,6892,1768,25.7,2466,3025,1401,645,159,2,486,312,1004,843,16,Serie A,2018-2019,23275147453355121
13,Bordeaux,33,38.0,704,435,340,290,74,228,732,31.1,504,6759,1757,26.0,2339,3197,1223,545,122,3,423,306,1010,945,11,Ligue 1,2018-2019,12683680850395737
14,Bournemouth,28,38.0,522,326,277,191,54,159,487,32.6,328,6486,1537,23.7,2432,2816,1238,598,161,4,437,379,901,1097,7,Premier League,2018-2019,36088947257895306
15,Brighton,21,38.0,709,437,397,225,87,197,584,33.7,387,6365,1607,25.2,2544,2672,1149,645,190,2,455,408,1117,1069,9,Premier League,2018-2019,49072214318111932
16,Burnley,23,38.0,617,355,303,251,63,209,572,36.5,363,6109,1481,24.2,2117,2642,1350,732,238,10,494,409,1026,1219,17,Premier League,2018-2019,21823480134907726
17,Caen,27,38.0,681,412,372,257,52,239,756,31.6,517,6401,1593,24.9,2488,2898,1015,604,148,4,456,317,998,1040,6,Ligue 1,2018-2019,21277886218272520
18,Cagliari,30,38.0,651,421,293,250,108,222,624,35.6,402,5728,1482,25.9,1894,2399,1435,604,133,1,471,257,908,858,12,Serie A,2018-2019,32968728316179674
19,Cardiff City,25,38.0,692,416,374,244,74,193,598,32.3,405,6987,1817,26.0,2623,3195,1169,672,158,5,514,507,1199,1011,9,Premier League,2018-2019,69924771535350567
20,Celta Vigo,28,38.0,620,399,335,222,63,239,674,35.5,435,6596,1717,26.0,2289,3010,1297,563,101,2,462,272,892,933,10,La Liga,2018-2019,14218303985450920
21,Chelsea,24,38.0,644,428,307,245,92,184,532,34.6,348,5877,1719,29.2,1822,2523,1532,502,83,5,419,365,1009,663,5,Premier League,2018-2019,58172670324373785
22,Chievo,36,38.0,687,460,354,257,76,249,711,35.0,462,7284,1728,23.7,2467,3369,1448,608,135,2,473,362,1049,955,12,Serie A,2018-2019,83748145049842906
23,Crystal Palace,26,38.0,774,461,423,262,89,234,628,37.3,394,6576,1709,26.0,2842,2636,1098,710,171,1,539,458,1232,1112,14,Premier League,2018-2019,15352059381074619
24,Dijon,26,38.0,705,439,353,276,76,202,707,28.6,505,6339,1652,26.1,2082,2929,1328,588,130,8,458,307,1012,875,18,Ligue 1,2018-2019,59239312409540653
25,Dortmund,23,34.0,519,346,245,210,64,167,458,36.5,291,5051,1452,28.7,1517,2269,1265,467,77,1,390,291,810,675,11,Bundesliga,2018-2019,6921931827204601
26,Düsseldorf,24,34.0,619,391,348,218,53,190,593,32.0,403,5911,1511,25.6,2199,2822,890,498,109,4,389,320,939,784,11,Bundesliga,2018-2019,6414184432322702
27,Eibar,25,38.0,644,447,249,287,108,225,646,34.8,421,6080,1906,31.3,1423,2762,1895,547,65,1,482,296,940,908,10,La Liga,2018-2019,67267904110326262
28,Eint Frankfurt,30,34.0,589,386,287,236,66,179,516,34.7,337,5874,1786,30.4,1893,2721,1260,583,100,9,483,314,903,702,5,Bundesliga,2018-2019,37929111009288632
29,Empoli,29,38.0,590,372,286,222,82,193,547,35.3,354,6206,1535,24.7,2292,2665,1249,555,148,4,407,270,860,758,5,Serie A,2018-2019,77726683749984272
30,Espanyol,25,38.0,674,443,345,248,81,248,785,31.6,537,6186,1433,23.2,2102,2845,1239,552,133,5,419,337,1011,1031,12,La Liga,2018-2019,71314269182841176
31,Everton,23,38.0,756,458,384,276,96,199,547,36.4,348,6345,1830,28.8,2157,2812,1376,560,102,0,458,524,1280,1081,15,Premier League,2018-2019,57482013681231466
32,Fiorentina,27,38.0,621,404,295,262,64,213,574,37.1,361,5521,1467,26.6,1800,2550,1171,594,136,3,458,326,947,901,8,Serie A,2018-2019,24325362613855847
33,Freiburg,28,34.0,527,319,302,172,53,173,547,31.6,374,5225,1209,23.1,1791,2323,1111,482,125,2,357,281,808,816,8,Bundesliga,2018-2019,17577284562417651
34,Frosinone,33,38.0,596,385,336,197,63,206,603,34.2,397,6617,1627,24.6,2639,2747,1231,564,156,0,408,341,937,961,6,Serie A,2018-2019,87953309350363757
35,Fulham,28,38.0,625,404,344,229,52,214,581,36.8,367,6261,1669,26.7,2443,2684,1134,604,163,3,441,514,1139,1064,8,Premier League,2018-2019,19227944656237519
36,Genoa,31,38.0,740,470,374,277,89,285,686,41.5,401,6258,1638,26.2,2100,2787,1371,541,126,3,415,342,1082,965,7,Serie A,2018-2019,87033800759594150
37,Getafe,26,38.0,643,418,275,282,86,232,671,34.6,439,7118,1852,26.0,2002,3590,1526,605,91,1,514,347,990,938,7,La Liga,2018-2019,23789167582387071
38,Girona,26,38.0,593,369,297,239,57,247,687,36.0,440,6240,1516,24.3,2063,2961,1216,614,126,1,488,352,945,1031,9,La Liga,2018-2019,12545195302828957
39,Guingamp,30,38.0,743,498,361,304,78,209,604,34.6,395,6895,1825,26.5,2250,3352,1293,631,112,4,519,302,1045,825,7,Ligue 1,2018-2019,16872092436156260
40,Hannover 96,32,34.0,578,368,333,196,49,200,657,30.4,457,5355,1415,26.4,2081,2334,940,589,132,2,457,297,875,888,10,Bundesliga,2018-2019,10121335889457780
41,Hertha BSC,26,34.0,551,345,279,224,48,155,496,31.3,341,5488,1406,25.6,1797,2556,1135,580,121,4,459,295,846,787,5,Bundesliga,2018-2019,59737400018465050
42,Hoffenheim,29,34.0,567,348,255,238,74,190,539,35.3,349,4971,1406,28.3,1580,2323,1068,530,120,2,410,306,873,694,6,Bundesliga,2018-2019,29322720181807625
43,Huddersfield,31,38.0,754,434,357,312,85,232,710,32.7,478,6977,1901,27.2,2477,3148,1352,634,134,4,500,554,1308,845,8,Premier League,2018-2019,70397411865897550
44,Huesca,30,38.0,721,482,384,276,61,273,762,35.8,489,6264,1617,25.8,2076,3023,1165,553,120,3,433,368,1089,1066,11,La Liga,2018-2019,16593090704373522
45,Inter,23,38.0,640,401,284,254,102,232,664,34.9,432,5964,1644,27.6,1576,2635,1753,521,120,1,401,271,911,635,6,Serie A,2018-2019,53198597771575973
46,Juventus,31,38.0,583,383,270,227,86,213,577,36.9,364,5679,1494,26.3,1683,2559,1437,534,140,3,394,329,912,655,11,Serie A,2018-2019,19371054131726661
47,Lazio,30,38.0,671,434,308,273,90,238,693,34.3,455,5778,1619,28.0,1899,2642,1237,615,154,0,461,367,1038,734,10,Serie A,2018-2019,90751438076496109
48,Leganés,29,38.0,636,417,334,238,64,240,711,33.8,471,6369,1508,23.7,2196,2848,1325,515,84,2,431,326,962,1081,9,La Liga,2018-2019,20237473683555152
49,Leicester City,25,38.0,737,445,397,265,75,197,572,34.4,375,6623,1929,29.1,2357,2920,1346,648,110,0,538,418,1155,1002,7,Premier League,2018-2019,18776461863573874
50,Levante,26,38.0,590,377,322,210,58,219,747,29.3,528,5943,1405,23.6,2007,2712,1224,622,142,3,480,302,892,883,9,La Liga,2018-2019,1566092639264277
51,Leverkusen,21,34.0,564,371,305,202,57,181,546,33.2,365,5021,1580,31.5,1579,2327,1115,548,98,2,450,293,857,705,4,Bundesliga,2018-2019,36794408106212849
52,Lille,25,38.0,641,434,308,264,69,240,665,36.1,425,5904,1596,27.0,1882,2852,1170,580,111,1,469,267,908,801,7,Ligue 1,2018-2019,85603837513355486
53,Liverpool,23,38.0,620,397,268,258,94,178,557,32.0,379,6070,1840,30.3,1762,2651,1657,510,91,2,419,321,941,730,14,Premier League,2018-2019,41956650829873911
54,Lyon,25,38.0,591,389,285,230,76,186,520,35.8,334,5866,1644,28.0,1791,2705,1370,551,143,4,408,315,906,726,6,Ligue 1,2018-2019,87005642993871754
55,M'Gladbach,22,34.0,512,322,252,209,51,158,479,33.0,321,5171,1268,24.5,1628,2515,1028,509,98,1,411,261,773,620,10,Bundesliga,2018-2019,81611584009946193
56,Mainz 05,28,34.0,519,300,247,211,61,157,512,30.7,355,5542,1374,24.8,1666,2541,1335,539,122,3,417,286,805,756,10,Bundesliga,2018-2019,71158960989778912
57,Manchester City,21,38.0,535,361,224,228,83,176,488,36.1,312,5406,1579,29.2,1334,2467,1605,430,76,2,354,325,860,738,7,Premier League,2018-2019,74026506610392765
58,Manchester Utd,28,38.0,615,375,315,229,71,205,550,37.3,345,5883,1552,26.4,2081,2588,1214,586,135,0,451,380,995,950,7,Premier League,2018-2019,29078730489839024
59,Marseille,24,38.0,728,444,340,300,88,244,755,32.3,511,6462,1860,28.8,2006,3079,1377,537,115,4,422,271,999,703,12,Ligue 1,2018-2019,66190039714113630
60,Milan,23,38.0,684,453,359,238,87,252,708,35.6,456,6489,1714,26.4,2201,2873,1415,585,124,2,461,286,970,842,14,Serie A,2018-2019,59378513948613436
61,Monaco,42,38.0,732,453,374,273,85,234,742,31.5,508,6452,1749,27.1,2092,3006,1354,503,92,1,411,295,1027,837,6,Ligue 1,2018-2019,79093238158793616
62,Montpellier,25,38.0,751,424,367,291,93,275,784,35.1,509,6593,1690,25.6,2254,3193,1146,605,117,3,488,320,1071,858,9,Ligue 1,2018-2019,32434714471076965
63,Nantes,33,38.0,768,481,379,293,96,241,749,32.2,508,6768,1907,28.2,2328,3227,1213,564,117,2,447,345,1113,894,6,Ligue 1,2018-2019,25802633648495862
64,Napoli,26,38.0,657,446,280,266,111,253,690,36.7,437,6255,1634,26.1,1639,2807,1809,522,114,3,408,262,919,554,4,Serie A,2018-2019,10516137814401134
65,Newcastle Utd,24,38.0,730,430,394,266,70,209,655,31.9,446,7027,1778,25.3,2749,3146,1132,734,154,4,580,500,1230,1258,9,Premier League,2018-2019,29528772732587842
66,Nice,30,38.0,642,385,336,241,65,226,679,33.3,453,6017,1591,26.4,2135,2715,1167,592,124,5,468,325,967,802,9,Ligue 1,2018-2019,11720969662561653
67,Nîmes,23,38.0,735,462,398,258,79,264,798,33.1,534,6440,1703,26.4,2180,3080,1180,615,120,2,495,277,1012,892,10,Ligue 1,2018-2019,83514802313158576
68,Nürnberg,27,34.0,564,363,342,179,43,212,564,37.6,352,5417,1257,23.2,2204,2328,885,511,122,2,389,290,854,877,5,Bundesliga,2018-2019,10689243141507842
69,Paris S-G,30,38.0,668,421,286,285,97,251,740,33.9,489,6356,1821,28.7,1802,2962,1592,516,104,2,412,249,917,553,13,Ligue 1,2018-2019,11177590892093073
70,Parma,31,38.0,581,366,334,196,51,195,626,31.2,431,6728,1538,22.9,2930,2687,1111,686,189,4,497,314,895,1132,9,Serie A,2018-2019,62695319081093388
71,Rayo Vallecano,29,38.0,646,425,360,224,62,223,655,34.0,432,5742,1520,26.5,2144,2605,993,551,79,2,472,326,972,1031,8,La Liga,2018-2019,75203699329351977
72,RB Leipzig,23,34.0,649,394,304,270,75,224,613,36.5,389,5668,1830,32.3,1548,2747,1373,563,78,6,485,321,970,832,7,Bundesliga,2018-2019,68159208261559796
73,Real Madrid,27,38.0,634,418,285,252,97,196,658,29.8,462,5700,1505,26.4,1538,2732,1430,529,86,4,443,322,956,605,6,La Liga,2018-2019,29627131003986350
74,Real Sociedad,30,38.0,606,399,311,230,65,241,663,36.3,422,6432,1631,25.4,1987,3054,1391,611,113,4,498,331,937,907,12,La Liga,2018-2019,57299950304530590
75,Reims,27,38.0,759,453,437,243,79,251,772,32.5,521,7066,1773,25.1,2548,3131,1387,586,118,2,468,344,1103,966,8,Ligue 1,2018-2019,67732085073987538
76,Rennes,28,38.0,641,378,294,262,85,232,704,33.0,472,6289,1686,26.8,2168,2932,1189,548,123,5,425,285,926,811,5,Ligue 1,2018-2019,96819424452761337
77,Roma,26,38.0,543,351,239,221,83,220,646,34.1,426,5885,1482,25.2,1857,2701,1327,571,168,0,403,325,868,839,10,Serie A,2018-2019,764736481564168
78,Saint-Étienne,29,38.0,669,427,317,267,85,210,709,29.6,499,5978,1586,26.5,2004,2790,1184,517,95,2,422,304,973,826,12,Ligue 1,2018-2019,56226069621228236
79,Sampdoria,24,38.0,668,411,310,258,100,245,648,37.8,403,6143,1572,25.6,1706,2757,1680,620,128,0,492,224,892,770,11,Serie A,2018-2019,89407679695143145
80,Sassuolo,29,38.0,577,378,310,198,69,184,527,34.9,343,5512,1437,26.1,1939,2312,1261,522,121,6,401,299,876,808,12,Serie A,2018-2019,79200252522790650
81,Schalke 04,32,34.0,627,384,283,270,74,207,634,32.6,427,5723,1529,26.7,1735,2727,1261,577,118,0,459,285,912,749,4,Bundesliga,2018-2019,24345039935475884
82,Sevilla,27,38.0,621,422,323,220,78,200,590,33.9,390,5782,1501,26.0,1859,2623,1300,529,119,1,410,296,917,908,6,La Liga,2018-2019,22702270477938803
83,Southampton,30,38.0,754,449,380,277,97,250,715,35.0,465,7110,1974,27.8,2530,3035,1545,711,166,4,545,500,1254,1160,14,Premier League,2018-2019,21037626007536306
84,SPAL,28,38.0,613,389,335,212,66,244,619,39.4,375,5607,1381,24.6,2135,2418,1054,607,157,2,450,319,932,859,10,Serie A,2018-2019,73622612860183040
85,Strasbourg,26,38.0,647,384,317,247,83,214,626,34.2,412,6269,1570,25.0,2262,2917,1090,536,129,4,407,347,994,796,10,Ligue 1,2018-2019,92234479374253707
86,Stuttgart,26,34.0,605,382,343,201,61,161,503,32.0,342,5351,1439,26.9,1930,2387,1034,551,122,2,429,288,893,892,7,Bundesliga,2018-2019,81761661302668293
87,Torino,25,38.0,683,469,308,283,92,206,589,35.0,383,5915,1733,29.3,1914,2744,1257,689,130,2,559,389,1072,850,6,Serie A,2018-2019,21846272194836439
88,Tottenham,28,38.0,661,406,337,219,105,206,572,36.0,366,5479,1592,29.1,1847,2344,1288,562,128,4,434,386,1047,875,7,Premier League,2018-2019,22006624071753704
89,Toulouse,29,38.0,705,459,394,227,84,239,655,36.5,416,6537,1739,26.6,2478,2789,1270,633,142,3,491,300,1005,919,9,Ligue 1,2018-2019,94523000561782573
90,Udinese,31,38.0,708,427,394,244,70,278,706,39.4,428,6337,1500,23.7,2438,2865,1034,689,172,3,517,343,1051,1038,7,Serie A,2018-2019,48393495896639342
91,Valencia,25,38.0,579,381,299,212,68,204,626,32.6,422,6489,1598,24.6,2042,3074,1373,600,131,1,469,357,936,933,12,La Liga,2018-2019,65158650443085242
92,Valladolid,28,38.0,692,452,379,241,72,255,792,32.2,537,6253,1570,25.1,2337,2936,980,597,118,2,479,317,1009,940,14,La Liga,2018-2019,44089518275887893
93,Villarreal,26,38.0,670,425,351,255,64,266,755,35.2,489,6516,1512,23.2,2115,3147,1254,566,154,4,412,302,972,957,10,La Liga,2018-2019,63335634096533483
94,Watford,25,38.0,693,438,371,247,75,212,632,33.5,420,6550,1828,27.9,2430,2840,1280,596,128,2,468,454,1147,1035,4,Premier League,2018-2019,73743918793554398
95,Werder Bremen,24,34.0,540,337,260,212,68,173,558,31.0,385,5510,1470,26.7,1730,2677,1103,534,112,1,422,305,845,855,7,Bundesliga,2018-2019,59303898890876434
96,West Ham,26,38.0,746,469,404,272,70,258,745,34.6,487,6442,1681,26.1,2551,2774,1117,645,148,2,497,491,1237,973,10,Premier League,2018-2019,57680956417459581
97,Wolfsburg,25,34.0,589,397,303,217,69,209,572,36.5,363,5501,1519,27.6,1778,2415,1308,542,95,1,447,291,880,815,5,Bundesliga,2018-2019,85159484018358879
98,Wolves,21,38.0,737,426,398,276,63,261,696,37.5,435,6122,1666,27.2,2326,2845,951,641,157,2,484,447,1184,1027,8,Premier League,2018-2019,24001928852251903
1,Alavés,30,38.0,606,383,335,205,66,188,611,30.8,423,6355,1521,23.9,2161,3024,1170,605,137,1,468,348,954,681,10,La Liga,2017-2018,37745278530914180
2,Amiens,30,38.0,606,369,339,203,64,168,529,31.8,361,4874,1347,27.6,1849,2140,885,650,174,4,476,502,1108,765,12,Ligue 1,2017-2018,20069478421376018
3,Angers,27,38.0,571,357,320,194,57,167,623,26.8,456,5172,1333,25.8,1699,2510,963,566,81,2,485,402,973,550,11,Ligue 1,2017-2018,66587352409382849
4,Arsenal,30,38.0,694,440,327,270,97,260,663,39.2,403,5449,1754,32.2,1783,2395,1271,507,116,3,391,482,1176,938,12,Premier League,2017-2018,5838645288327307
5,Atalanta,25,38.0,762,469,354,325,83,217,702,30.9,485,6213,1985,31.9,1864,3021,1328,612,116,0,496,338,1100,883,4,Serie A,2017-2018,87465877057901989
6,Athletic Club,26,38.0,625,373,306,251,68,195,656,29.7,461,6864,1827,26.6,1969,3260,1635,595,109,3,486,354,979,508,10,La Liga,2017-2018,4823083458145023
7,Atlético Madrid,26,38.0,714,463,375,263,76,205,668,30.7,463,6726,1852,27.5,2290,3035,1401,678,127,1,551,358,1072,585,13,La Liga,2017-2018,74713976168286555
8,Augsburg,27,34.0,605,392,304,242,59,201,562,35.8,361,5318,1525,28.7,1700,2444,1174,513,111,2,402,316,921,931,10,Bundesliga,2017-2018,82828683183786310
9,Barcelona,25,38.0,499,345,233,194,72,158,509,31.0,351,6408,1786,27.9,1800,2956,1652,530,105,4,425,353,852,370,12,La Liga,2017-2018,81744823723090567
10,Bayern Munich,28,34.0,523,343,241,207,75,185,478,38.7,293,4692,1626,34.7,1302,2114,1276,420,85,4,335,272,795,548,3,Bundesliga,2017-2018,7510926916741648
11,Benevento,41,38.0,634,409,351,217,66,198,645,30.7,447,5613,1574,28.0,2231,2357,1025,568,150,2,418,300,934,751,13,Serie A,2017-2018,38159059008947812
12,Betis,29,38.0,500,321,263,181,56,136,490,27.8,354,5764,1535,26.6,1906,2698,1160,562,102,5,460,336,836,596,11,La Liga,2017-2018,9423348454032625
13,Bologna,30,38.0,706,446,373,260,73,269,687,39.2,418,6239,1749,28.0,2441,2703,1095,659,132,2,527,248,954,933,5,Serie A,2017-2018,23275147453355121
14,Bordeaux,31,38.0,652,412,332,252,68,187,579,32.3,392,5072,1461,28.8,1646,2339,1087,521,112,4,409,432,1084,577,12,Ligue 1,2017-2018,12683680850395737
15,Bournemouth,22,38.0,582,331,298,212,72,192,552,34.8,360,5642,1551,27.5,1897,2567,1178,622,175,6,447,465,1047,1325,8,Premier League,2017-2018,36088947257895306
16,Brighton,24,38.0,691,447,409,237,45,232,730,31.8,498,6152,1735,28.2,2549,2578,1025,638,209,7,429,554,1245,1228,19,Premier League,2017-2018,49072214318111932
17,Burnley,24,38.0,576,349,296,222,58,216,629,34.3,413,5996,1645,27.4,2051,2683,1262,675,210,6,465,526,1102,1482,9,Premier League,2017-2018,21823480134907726
18,Caen,26,38.0,638,372,350,224,64,199,654,30.4,455,5833,1541,26.4,1963,2727,1143,631,105,2,526,515,1153,675,11,Ligue 1,2017-2018,21277886218272520
19,Cagliari,29,38.0,729,442,377,265,87,197,616,32.0,419,5851,1743,29.8,2124,2523,1204,567,127,1,440,273,1002,981,7,Serie A,2017-2018,32968728316179674
20,Celta Vigo,23,38.0,488,306,278,166,44,148,463,32.0,315,5639,1614,28.6,1915,2496,1228,535,107,1,428,306,794,487,9,La Liga,2017-2018,14218303985450920
21,Chelsea,26,38.0,722,445,358,285,79,237,582,40.7,345,5276,1727,32.7,1922,2329,1025,510,129,2,381,508,1230,805,10,Premier League,2017-2018,58172670324373785
22,Chievo,25,38.0,651,391,325,237,89,219,639,34.3,420,6246,1601,25.6,2281,2672,1293,682,175,2,507,303,954,1054,5,Serie A,2017-2018,83748145049842906
23,Crotone,29,38.0,691,409,338,269,84,189,683,27.7,494,6270,1613,25.7,2166,2881,1223,666,137,3,529,362,1053,1079,12,Serie A,2017-2018,33431629624225246
24,Crystal Palace,28,38.0,759,451,429,267,63,258,681,37.9,423,5653,1657,29.3,2193,2442,1018,643,131,5,512,632,1391,1214,12,Premier League,2017-2018,15352059381074619
25,Dijon,26,38.0,628,384,347,227,54,155,550,28.2,395,5360,1490,27.8,1877,2419,1064,555,123,4,432,474,1102,586,7,Ligue 1,2017-2018,59239312409540653
26,Dortmund,30,34.0,601,395,279,251,71,178,518,34.4,340,5218,1654,31.7,1632,2310,1276,486,81,0,405,274,875,784,7,Bundesliga,2017-2018,6921931827204601
27,Eibar,27,38.0,490,330,214,208,68,155,555,27.9,400,5993,1884,31.4,1365,2727,1901,526,55,0,471,386,876,394,9,La Liga,2017-2018,67267904110326262
28,Eint Frankfurt,28,34.0,615,414,276,271,68,196,561,34.9,365,5946,1802,30.3,1786,2837,1323,561,108,5,453,292,907,832,6,Bundesliga,2017-2018,37929111009288632
29,Espanyol,25,38.0,573,353,313,201,59,187,637,29.4,450,6157,1580,25.7,1928,2911,1318,553,121,2,432,346,919,571,9,La Liga,2017-2018,71314269182841176
30,Everton,30,38.0,748,458,408,259,81,248,667,37.2,419,6587,1816,27.6,2450,2788,1349,641,176,6,465,580,1328,1297,9,Premier League,2017-2018,57482013681231466
31,Fiorentina,27,38.0,782,496,365,299,118,234,697,33.6,463,6122,1846,30.2,1833,2801,1488,641,88,2,553,334,1116,864,8,Serie A,2017-2018,24325362613855847
32,Freiburg,29,34.0,543,334,262,233,48,167,492,33.9,325,6041,1584,26.2,1900,2891,1250,522,125,1,397,255,798,1031,10,Bundesliga,2017-2018,17577284562417651
33,Genoa,33,38.0,603,407,303,240,60,178,566,31.4,388,6025,1739,28.9,2119,2821,1085,561,126,4,435,306,909,882,12,Serie A,2017-2018,87033800759594150
34,Getafe,32,38.0,573,390,309,206,58,202,648,31.2,446,6210,1583,25.5,1926,3029,1255,567,79,0,488,343,916,560,11,La Liga,2017-2018,23789167582387071
35,Girona,25,38.0,498,317,249,195,54,164,555,29.5,391,6038,1547,25.6,1731,3003,1304,530,96,3,434,340,838,533,12,La Liga,2017-2018,12545195302828957
36,Guingamp,23,38.0,564,346,307,193,64,161,536,30.0,375,4879,1344,27.5,1618,2246,1015,518,129,5,389,482,1046,621,6,Ligue 1,2017-2018,16872092436156260
37,Hamburger SV,29,34.0,644,394,334,250,60,194,620,31.3,426,5766,1810,31.4,1865,2660,1241,587,118,3,469,247,891,848,8,Bundesliga,2017-2018,42905483414913667
38,Hannover 96,26,34.0,619,365,333,230,56,207,683,30.3,476,5860,1711,29.2,2061,2718,1081,590,142,4,448,283,902,1024,8,Bundesliga,2017-2018,10121335889457780
39,Hellas Verona,32,38.0,711,446,377,255,79,224,671,33.4,447,5655,1513,26.8,2125,2465,1065,600,164,6,436,340,1051,1014,11,Serie A,2017-2018,45227680351245381
40,Hertha BSC,25,34.0,588,358,293,247,48,159,446,35.7,287,6162,1636,26.5,2121,2937,1104,544,103,5,441,301,889,1010,6,Bundesliga,2017-2018,59737400018465050
41,Hoffenheim,26,34.0,617,390,291,259,67,194,559,34.7,365,6035,1819,30.1,2031,2896,1108,528,106,2,422,269,886,679,9,Bundesliga,2017-2018,29322720181807625
42,Huddersfield,25,38.0,828,462,388,348,92,240,671,35.8,431,6570,2027,30.9,2361,2873,1336,640,133,7,507,543,1371,1268,14,Premier League,2017-2018,70397411865897550
43,Inter,22,38.0,694,443,350,266,78,243,664,36.6,421,5815,1650,28.4,1775,2562,1478,532,123,1,409,262,956,749,6,Serie A,2017-2018,53198597771575973
44,Juventus,24,38.0,585,370,261,225,99,164,508,32.3,344,5155,1446,28.1,1631,2292,1232,492,84,1,408,283,868,606,7,Serie A,2017-2018,19371054131726661
45,Köln,31,34.0,605,390,316,240,49,184,551,33.4,367,5574,1539,27.6,2125,2480,969,547,126,6,421,278,883,839,4,Bundesliga,2017-2018,39731782814123330
46,La Coruña,32,38.0,606,377,327,227,52,177,604,29.3,427,6643,1644,24.7,2430,2884,1329,595,119,1,476,321,927,638,14,La Liga,2017-2018,31828180925314031
47,Las Palmas,36,38.0,540,373,287,198,55,182,592,30.7,410,5557,1496,26.9,1773,2575,1209,551,116,3,435,324,864,450,9,La Liga,2017-2018,33189055458748528
48,Lazio,24,38.0,657,437,306,278,73,205,661,31.0,456,5547,1784,32.2,1804,2519,1224,590,114,3,476,316,973,603,7,Serie A,2017-2018,90751438076496109
49,Leganés,28,38.0,627,420,304,264,59,218,631,34.5,413,6674,1833,27.5,1984,3250,1440,563,91,2,472,470,1097,477,8,La Liga,2017-2018,20237473683555152
50,Leicester City,27,38.0,703,434,376,261,66,203,662,30.7,459,6054,1757,29.0,2233,2639,1182,620,153,4,467,584,1287,1187,6,Premier League,2017-2018,18776461863573874
51,Levante,33,38.0,497,345,271,178,48,154,525,29.3,371,6613,1539,23.3,2299,3047,1267,601,137,5,464,381,878,585,9,La Liga,2017-2018,1566092639264277
52,Leverkusen,24,34.0,560,371,273,229,58,207,591,35.0,384,5569,1761,31.6,1694,2728,1147,544,90,3,454,263,823,646,7,Bundesliga,2017-2018,36794408106212849
53,Lille,25,38.0,609,367,338,213,58,174,502,34.7,328,4622,1335,28.9,1606,2115,901,542,111,4,431,445,1054,519,16,Ligue 1,2017-2018,85603837513355486
54,Liverpool,27,38.0,706,449,299,300,107,207,565,36.6,358,5704,1886,33.1,1592,2720,1392,492,80,2,412,522,1228,1048,10,Premier League,2017-2018,41956650829873911
55,Lyon,26,38.0,568,362,293,205,70,153,480,31.9,327,6138,1724,28.1,2076,2677,1385,517,119,3,398,437,1005,525,14,Ligue 1,2017-2018,87005642993871754
56,M'Gladbach,27,34.0,597,385,302,229,66,208,532,39.1,324,5136,1434,27.9,1701,2403,1032,562,114,3,448,250,847,805,8,Bundesliga,2017-2018,81611584009946193
57,Mainz 05,27,34.0,626,413,303,249,74,174,539,32.3,365,5876,1753,29.8,1910,2651,1315,616,126,4,490,300,926,905,7,Bundesliga,2017-2018,71158960989778912
58,Málaga,37,38.0,596,384,319,217,60,200,638,31.3,438,6643,1663,25.0,2183,3128,1332,610,98,2,512,337,933,601,6,La Liga,2017-2018,79809637287620621
59,Manchester City,25,38.0,641,406,260,274,107,217,605,35.9,388,4697,1584,33.7,1241,2111,1345,393,64,2,329,472,1113,774,15,Premier League,2017-2018,74026506610392765
60,Manchester Utd,27,38.0,595,372,270,248,77,191,581,32.9,390,5745,1644,28.6,1827,2653,1265,542,130,3,412,591,1186,964,10,Premier League,2017-2018,29078730489839024
61,Marseille,26,38.0,663,406,328,252,83,202,573,35.3,371,4573,1471,32.2,1497,1976,1100,561,102,4,459,405,1068,391,8,Ligue 1,2017-2018,66190039714113630
62,Metz,36,38.0,663,401,365,224,74,221,620,35.6,399,4592,1343,29.2,1689,2033,870,524,107,4,417,416,1079,548,13,Ligue 1,2017-2018,14635757597311544
63,Milan,23,38.0,530,347,238,208,84,170,535,31.8,365,5483,1482,27.0,1640,2514,1329,584,120,3,464,263,793,637,6,Serie A,2017-2018,59378513948613436
64,Monaco,32,38.0,609,373,257,254,98,182,607,30.0,425,5299,1497,28.3,1487,2439,1373,545,107,5,438,424,1033,549,11,Ligue 1,2017-2018,79093238158793616
65,Montpellier,23,38.0,598,373,326,216,56,166,479,34.7,313,5227,1451,27.8,1740,2470,1017,529,104,0,425,415,1013,544,15,Ligue 1,2017-2018,32434714471076965
66,Nantes,30,38.0,673,403,376,236,61,229,618,37.1,389,5033,1371,27.2,1590,2283,1160,692,154,6,538,457,1130,691,8,Ligue 1,2017-2018,25802633648495862
67,Napoli,23,38.0,656,426,231,323,102,200,646,31.0,446,6059,1820,30.0,1191,2780,2088,497,77,1,420,262,918,471,3,Serie A,2017-2018,10516137814401134
68,Newcastle Utd,27,38.0,728,410,393,256,79,229,664,34.5,435,6420,1696,26.4,2495,2730,1195,670,133,6,537,556,1284,1400,9,Premier League,2017-2018,29528772732587842
69,Nice,31,38.0,536,319,327,154,55,176,505,34.9,329,4664,1303,27.9,1832,1875,957,561,138,2,423,414,950,479,7,Ligue 1,2017-2018,11720969662561653
70,Paris S-G,26,38.0,571,375,274,206,91,166,516,32.2,350,4395,1345,30.6,1427,1763,1205,473,109,3,364,299,870,395,5,Ligue 1,2017-2018,11177590892093073
71,RB Leipzig,23,34.0,605,373,286,238,81,181,575,31.5,394,5322,1716,32.2,1565,2493,1264,577,96,1,481,279,884,810,8,Bundesliga,2017-2018,68159208261559796
72,Real Madrid,24,38.0,559,391,267,218,74,158,579,27.3,421,6349,1732,27.3,1893,2884,1572,473,86,7,387,335,894,360,8,La Liga,2017-2018,29627131003986350
73,Real Sociedad,27,38.0,455,298,215,189,51,145,488,29.7,343,5855,1566,26.7,1738,2668,1449,524,99,4,425,300,755,450,7,La Liga,2017-2018,57299950304530590
74,Rennes,28,38.0,497,315,248,178,71,157,573,27.4,416,5207,1411,27.1,1553,2373,1281,598,102,6,496,434,931,604,13,Ligue 1,2017-2018,96819424452761337
75,Roma,27,38.0,576,383,254,215,107,176,507,34.7,331,5051,1489,29.5,1389,2180,1482,539,119,4,420,287,863,626,13,Serie A,2017-2018,764736481564168
76,Saint-Étienne,30,38.0,558,352,315,184,59,189,567,33.3,378,4936,1353,27.4,1817,2125,994,626,134,6,492,380,938,641,20,Ligue 1,2017-2018,56226069621228236
77,Sampdoria,27,38.0,672,415,281,281,110,241,687,35.1,446,5783,1628,28.2,1595,2459,1729,645,126,3,519,264,936,752,10,Serie A,2017-2018,89407679695143145
78,Sassuolo,28,38.0,608,389,310,212,86,205,648,31.6,443,6254,1722,27.5,2054,2764,1436,620,112,0,508,313,921,921,12,Serie A,2017-2018,79200252522790650
79,Schalke 04,24,34.0,670,434,314,282,74,205,581,35.3,376,5759,1753,30.4,1691,2782,1286,579,95,2,484,315,985,764,6,Bundesliga,2017-2018,24345039935475884
80,Sevilla,31,38.0,607,384,300,240,67,192,602,31.9,410,5667,1531,27.0,1704,2652,1311,589,127,3,462,317,924,529,10,La Liga,2017-2018,22702270477938803
81,Southampton,26,38.0,767,481,412,274,81,232,628,36.9,396,5802,1814,31.3,2112,2479,1211,603,151,3,452,519,1286,1188,10,Premier League,2017-2018,21037626007536306
82,SPAL,29,38.0,675,423,344,262,69,223,649,34.4,426,5340,1463,27.4,2143,2270,927,590,162,1,428,332,1007,903,8,Serie A,2017-2018,73622612860183040
83,Stoke City,30,38.0,766,433,420,277,69,252,642,39.3,390,5971,1633,27.3,2405,2572,994,595,153,3,442,540,1306,1271,10,Premier League,2017-2018,55848606059653975
84,Strasbourg,25,38.0,666,442,396,213,57,186,578,32.2,392,4537,1279,28.2,1665,1992,880,533,97,3,436,473,1139,568,19,Ligue 1,2017-2018,92234479374253707
85,Stuttgart,26,34.0,606,388,311,235,60,187,507,36.9,320,6030,1745,28.9,1976,2823,1231,560,116,3,444,302,908,806,10,Bundesliga,2017-2018,81761661302668293
86,Swansea City,26,38.0,658,392,311,259,88,215,606,35.5,391,6104,1702,27.9,2189,2691,1224,557,137,1,420,524,1182,1111,9,Premier League,2017-2018,11897392087106032
87,Torino,27,38.0,616,366,304,238,74,173,508,34.1,335,5660,1615,28.5,1854,2525,1281,547,120,2,427,314,930,871,10,Serie A,2017-2018,21846272194836439
88,Tottenham,25,38.0,693,421,286,294,113,224,600,37.3,376,5123,1757,34.3,1482,2339,1302,517,92,0,425,449,1142,872,11,Premier League,2017-2018,22006624071753704
89,Toulouse,25,38.0,589,338,326,194,69,169,550,30.7,381,4953,1342,27.1,1832,2097,1024,579,116,0,463,430,1019,594,13,Ligue 1,2017-2018,94523000561782573
90,Troyes,25,38.0,544,317,326,156,62,148,565,26.2,417,5851,1493,25.5,2327,2559,965,551,128,4,423,446,990,658,13,Ligue 1,2017-2018,57069542099991496
91,Udinese,27,38.0,654,407,348,238,68,209,622,33.6,413,6107,1674,27.4,2218,2746,1143,680,164,7,516,283,937,1001,7,Serie A,2017-2018,48393495896639342
92,Valencia,25,38.0,647,388,360,218,69,189,561,33.7,372,6404,1535,24.0,2174,2890,1340,593,113,0,480,347,994,664,10,La Liga,2017-2018,65158650443085242
93,Villarreal,32,38.0,591,384,312,229,50,196,637,30.8,441,5636,1366,24.2,1775,2612,1249,671,143,3,528,305,896,653,2,La Liga,2017-2018,63335634096533483
94,Watford,29,38.0,738,457,377,285,76,219,610,35.9,391,5974,1785,29.9,2063,2719,1192,506,112,5,394,590,1328,1195,13,Premier League,2017-2018,73743918793554398
95,Werder Bremen,25,34.0,571,353,290,224,57,185,532,34.8,347,5351,1505,28.1,1616,2673,1062,428,87,1,341,282,853,836,6,Bundesliga,2017-2018,59303898890876434
96,West Brom,24,38.0,673,400,371,227,75,259,697,37.2,438,5630,1595,28.3,2265,2297,1068,592,170,1,422,630,1303,1110,10,Premier League,2017-2018,26775906631723373
97,West Ham,27,38.0,659,409,346,239,74,222,648,34.3,426,5910,1740,29.4,2431,2418,1061,607,175,3,432,570,1229,1178,9,Premier League,2017-2018,57680956417459581
98,Wolfsburg,29,34.0,528,325,292,184,52,163,490,33.3,327,5173,1431,27.7,1843,2320,1010,510,124,4,386,258,786,839,5,Bundesliga,2017-2018,85159484018358879
